VACCINATION_DATE,Ethnicity,FirstDoseDaily,FirstDoseCumulative,SecondDoseDaily,SecondDoseCumulative,SingleDoseDaily,SingleDoseCumulative
2020-12-14 15:00:00,Unknown,1,1,,0,,0
2020-12-16 15:00:00,Unknown,10,11,,0,,0
2020-12-17 15:00:00,Unknown,16,27,,0,,0
2020-12-18 15:00:00,Unknown,89,116,,0,,0
2020-12-19 15:00:00,Unknown,27,143,,0,,0
2020-12-20 15:00:00,Unknown,32,175,,0,,0
2020-12-21 15:00:00,Unknown,70,245,,0,,0
2020-12-22 15:00:00,Unknown,418,663,,0,,0
2020-12-23 15:00:00,Unknown,191,854,,0,,0
2020-12-24 15:00:00,Unknown,61,915,,0,,0
2020-12-25 15:00:00,Unknown,183,1098,,0,,0
2020-12-26 15:00:00,Unknown,203,1301,,0,,0
2020-12-27 15:00:00,Unknown,142,1443,,0,,0
2020-12-28 15:00:00,Unknown,279,1722,,0,,0
2020-12-29 15:00:00,Unknown,445,2167,,0,,0
2020-12-30 15:00:00,Unknown,359,2526,,0,,0
2020-12-31 15:00:00,Unknown,201,2727,2.0,2,,0
2021-01-01 15:00:00,Unknown,150,2877,1.0,3,,0
2021-01-02 15:00:00,Unknown,170,3047,2.0,5,,0
2021-01-03 15:00:00,Unknown,235,3282,4.0,9,,0
2021-01-04 15:00:00,Unknown,590,3872,6.0,15,,0
2021-01-05 15:00:00,Unknown,484,4356,17.0,32,,0
2021-01-06 15:00:00,Unknown,659,5015,22.0,54,,0
2021-01-07 15:00:00,Unknown,419,5434,56.0,110,,0
2021-01-08 15:00:00,Unknown,8301,13735,74.0,184,,0
2021-01-09 15:00:00,Unknown,206,13941,40.0,224,,0
2021-01-10 15:00:00,Unknown,176,14117,10.0,234,,0
2021-01-11 15:00:00,Unknown,316,14433,77.0,311,,0
2021-01-12 15:00:00,Unknown,707,15140,347.0,658,,0
2021-01-13 15:00:00,Unknown,381,15521,134.0,792,,0
2021-01-14 15:00:00,Unknown,392,15913,59.0,851,,0
2021-01-15 15:00:00,Unknown,542,16455,181.0,1032,,0
2021-01-16 15:00:00,Unknown,307,16762,165.0,1197,,0
2021-01-17 15:00:00,Unknown,110,16872,98.0,1295,,0
2021-01-18 15:00:00,Unknown,181,17053,201.0,1496,,0
2021-01-19 15:00:00,Unknown,300,17353,237.0,1733,,0
2021-01-20 15:00:00,Unknown,331,17684,150.0,1883,,0
2021-01-21 15:00:00,Unknown,348,18032,72.0,1955,,0
2021-01-22 15:00:00,Unknown,710,18742,164.0,2119,,0
2021-01-23 15:00:00,Unknown,414,19156,127.0,2246,,0
2021-01-24 15:00:00,Unknown,201,19357,154.0,2400,,0
2021-01-25 15:00:00,Unknown,556,19913,472.0,2872,,0
2021-01-26 15:00:00,Unknown,644,20557,363.0,3235,,0
2021-01-27 15:00:00,Unknown,504,21061,529.0,3764,,0
2021-01-28 15:00:00,Unknown,478,21539,266.0,4030,,0
2021-01-29 15:00:00,Unknown,347,21886,170.0,4200,,0
2021-01-30 15:00:00,Unknown,305,22191,49.0,4249,,0
2021-01-31 15:00:00,Unknown,360,22551,86.0,4335,,0
2021-02-01 15:00:00,Unknown,412,22963,181.0,4516,,0
2021-02-02 15:00:00,Unknown,524,23487,631.0,5147,,0
2021-02-03 15:00:00,Unknown,674,24161,444.0,5591,,0
2021-02-04 15:00:00,Unknown,850,25011,403.0,5994,,0
2021-02-05 15:00:00,Unknown,664,25675,423.0,6417,,0
2021-02-06 15:00:00,Unknown,380,26055,8214.0,14631,,0
2021-02-07 15:00:00,Unknown,384,26439,89.0,14720,,0
2021-04-13 15:00:00,Federal Entities,84295,84295,54201.0,54201,2952.0,2952
2021-04-14 15:00:00,Federal Entities,557,84852,11.0,54212,1.0,2953
2021-04-15 15:00:00,Federal Entities,623,85475,823.0,55035,19.0,2972
2021-04-16 15:00:00,Federal Entities,782,86257,1016.0,56051,8.0,2980
2021-04-17 15:00:00,Federal Entities,1136,87393,1177.0,57228,6.0,2986
2021-04-19 15:00:00,Federal Entities,1369,88762,2003.0,59231,9.0,2995
2021-04-20 15:00:00,Federal Entities,3243,92005,2158.0,61389,19.0,3014
2021-04-21 15:00:00,Federal Entities,906,92911,1206.0,62595,4.0,3018
2021-04-22 15:00:00,Federal Entities,1018,93929,458.0,63053,,3018
2021-04-23 15:00:00,Federal Entities,759,94688,632.0,63685,1.0,3019
2021-04-25 15:00:00,Federal Entities,992,95680,2492.0,66177,5.0,3024
2021-04-26 15:00:00,Federal Entities,1483,97163,1672.0,67849,1.0,3025
2021-04-29 15:00:00,Federal Entities,223,97386,865.0,68714,2.0,3027
2021-05-01 15:00:00,Federal Entities,1556,98942,1974.0,70688,14.0,3041
2021-05-02 15:00:00,Federal Entities,1071,100013,1875.0,72563,4.0,3045
2021-05-03 15:00:00,Federal Entities,403,100416,2165.0,74728,4.0,3049
2021-05-04 15:00:00,Federal Entities,28,100444,25.0,74753,,3049
2021-05-05 15:00:00,Federal Entities,365,100809,814.0,75567,,3049
2021-05-06 15:00:00,Federal Entities,275,101084,880.0,76447,3.0,3052
2021-05-07 15:00:00,Federal Entities,274,101358,966.0,77413,8.0,3060
2021-05-08 15:00:00,Federal Entities,297,101655,1312.0,78725,6.0,3066
2021-05-10 15:00:00,Federal Entities,338,101993,1712.0,80437,1.0,3067
2021-05-11 15:00:00,Federal Entities,18,102011,13.0,80450,,3067
2021-05-12 15:00:00,Federal Entities,243,102254,1124.0,81574,,3067
2021-05-14 15:00:00,Federal Entities,290,102544,1022.0,82596,2.0,3069
2021-05-15 15:00:00,Federal Entities,611,103155,1701.0,84297,4.0,3073
2021-05-17 15:00:00,Federal Entities,565,103720,2505.0,86802,11.0,3084
2021-05-18 15:00:00,Federal Entities,164,103884,61.0,86863,2.0,3086
2021-05-20 15:00:00,Federal Entities,885,104769,1024.0,87887,,3086
2020-12-15 15:00:00,Hispanic or Latino,2,2,,0,,0
2020-12-16 15:00:00,Hispanic or Latino,18,20,,0,,0
2020-12-17 15:00:00,Hispanic or Latino,32,52,,0,,0
2020-12-18 15:00:00,Hispanic or Latino,84,136,,0,,0
2020-12-19 15:00:00,Hispanic or Latino,33,169,,0,,0
2020-12-20 15:00:00,Hispanic or Latino,8,177,,0,,0
2020-12-21 15:00:00,Hispanic or Latino,149,326,1.0,1,,0
2020-12-22 15:00:00,Hispanic or Latino,251,577,,1,,0
2020-12-23 15:00:00,Hispanic or Latino,182,759,1.0,2,,0
2020-12-24 15:00:00,Hispanic or Latino,89,848,,2,,0
2020-12-25 15:00:00,Hispanic or Latino,37,885,,2,,0
2020-12-26 15:00:00,Hispanic or Latino,39,924,,2,,0
2020-12-27 15:00:00,Hispanic or Latino,57,981,,2,,0
2020-12-28 15:00:00,Hispanic or Latino,258,1239,1.0,3,,0
2020-12-29 15:00:00,Hispanic or Latino,360,1599,1.0,4,,0
2020-12-30 15:00:00,Hispanic or Latino,500,2099,2.0,6,,0
2020-12-31 15:00:00,Hispanic or Latino,311,2410,2.0,8,,0
2021-01-01 15:00:00,Hispanic or Latino,47,2457,3.0,11,,0
2021-01-02 15:00:00,Hispanic or Latino,80,2537,2.0,13,,0
2021-01-03 15:00:00,Hispanic or Latino,117,2654,3.0,16,,0
2021-01-04 15:00:00,Hispanic or Latino,606,3260,11.0,27,,0
2021-01-05 15:00:00,Hispanic or Latino,399,3659,18.0,45,,0
2021-01-06 15:00:00,Hispanic or Latino,576,4235,19.0,64,,0
2021-01-07 15:00:00,Hispanic or Latino,799,5034,55.0,119,,0
2021-01-08 15:00:00,Hispanic or Latino,869,5903,89.0,208,,0
2021-01-09 15:00:00,Hispanic or Latino,195,6098,31.0,239,,0
2021-01-10 15:00:00,Hispanic or Latino,132,6230,21.0,260,,0
2021-01-11 15:00:00,Hispanic or Latino,549,6779,126.0,386,,0
2021-01-12 15:00:00,Hispanic or Latino,728,7507,204.0,590,,0
2021-01-13 15:00:00,Hispanic or Latino,662,8169,131.0,721,,0
2021-02-08 15:00:00,Unknown,662,27101,249.0,14969,,0
2021-02-09 15:00:00,Unknown,746,27847,289.0,15258,,0
2021-02-10 15:00:00,Unknown,827,28674,402.0,15660,,0
2021-02-11 15:00:00,Unknown,895,29569,398.0,16058,,0
2021-02-12 15:00:00,Unknown,749,30318,555.0,16613,,0
2021-02-13 15:00:00,Unknown,399,30717,157.0,16770,,0
2021-02-14 15:00:00,Unknown,448,31165,130.0,16900,,0
2021-02-15 15:00:00,Unknown,445,31610,491.0,17391,,0
2021-02-16 15:00:00,Unknown,724,32334,674.0,18065,,0
2021-02-17 15:00:00,Unknown,824,33158,453.0,18518,,0
2021-02-18 15:00:00,Unknown,285,33443,225.0,18743,,0
2021-02-19 15:00:00,Unknown,629,34072,416.0,19159,,0
2021-02-20 15:00:00,Unknown,473,34545,355.0,19514,,0
2021-02-21 15:00:00,Unknown,337,34882,263.0,19777,,0
2021-02-22 15:00:00,Unknown,450,35332,404.0,20181,,0
2021-02-23 15:00:00,Unknown,682,36014,347.0,20528,,0
2021-02-24 15:00:00,Unknown,618,36632,496.0,21024,,0
2021-02-25 15:00:00,Unknown,620,37252,824.0,21848,,0
2021-02-26 15:00:00,Unknown,744,37996,664.0,22512,,0
2021-02-27 15:00:00,Unknown,564,38560,301.0,22813,,0
2021-02-28 15:00:00,Unknown,651,39211,180.0,22993,,0
2021-03-01 15:00:00,Unknown,832,40043,471.0,23464,,0
2021-03-02 15:00:00,Unknown,769,40812,505.0,23969,,0
2021-03-03 15:00:00,Unknown,963,41775,587.0,24556,2.0,2
2021-03-04 15:00:00,Unknown,949,42724,676.0,25232,105.0,107
2021-03-05 15:00:00,Unknown,976,43700,559.0,25791,88.0,195
2021-03-06 15:00:00,Unknown,659,44359,300.0,26091,187.0,382
2021-03-07 15:00:00,Unknown,615,44974,318.0,26409,299.0,681
2021-03-08 15:00:00,Unknown,908,45882,345.0,26754,369.0,1050
2021-03-09 15:00:00,Unknown,868,46750,456.0,27210,381.0,1431
2021-03-10 15:00:00,Unknown,769,47519,495.0,27705,506.0,1937
2021-03-11 15:00:00,Unknown,965,48484,519.0,28224,180.0,2117
2021-03-12 15:00:00,Unknown,1199,49683,613.0,28837,146.0,2263
2021-03-13 15:00:00,Unknown,853,50536,373.0,29210,72.0,2335
2021-03-14 15:00:00,Unknown,1054,51590,359.0,29569,69.0,2404
2021-03-15 15:00:00,Unknown,1637,53227,411.0,29980,35.0,2439
2021-03-16 15:00:00,Unknown,1610,54837,587.0,30567,46.0,2485
2021-03-17 15:00:00,Unknown,1612,56449,681.0,31248,62.0,2547
2021-03-18 15:00:00,Unknown,1788,58237,453.0,31701,55.0,2602
2021-03-19 15:00:00,Unknown,1453,59690,426.0,32127,50.0,2652
2021-03-20 15:00:00,Unknown,1285,60975,444.0,32571,37.0,2689
2021-03-21 15:00:00,Unknown,1116,62091,335.0,32906,23.0,2712
2021-03-22 15:00:00,Unknown,1590,63681,492.0,33398,33.0,2745
2021-03-23 15:00:00,Unknown,2018,65699,611.0,34009,75.0,2820
2021-03-24 15:00:00,Unknown,2629,68328,523.0,34532,79.0,2899
2021-03-25 15:00:00,Unknown,2634,70962,585.0,35117,334.0,3233
2021-03-26 15:00:00,Unknown,2598,73560,669.0,35786,361.0,3594
2021-03-27 15:00:00,Unknown,1888,75448,511.0,36297,408.0,4002
2021-03-28 15:00:00,Unknown,1940,77388,507.0,36804,433.0,4435
2021-03-29 15:00:00,Unknown,2681,80069,945.0,37749,75.0,4510
2021-03-30 15:00:00,Unknown,2548,82617,967.0,38716,125.0,4635
2021-03-31 15:00:00,Unknown,2546,85163,852.0,39568,817.0,5452
2021-04-01 15:00:00,Unknown,1843,87006,983.0,40551,633.0,6085
2021-04-02 15:00:00,Unknown,1892,88898,1276.0,41827,764.0,6849
2021-04-03 15:00:00,Unknown,1664,90562,840.0,42667,679.0,7528
2021-04-04 15:00:00,Unknown,623,91185,715.0,43382,46.0,7574
2021-04-05 15:00:00,Unknown,1851,93036,1126.0,44508,679.0,8253
2021-04-06 15:00:00,Unknown,2235,95271,1254.0,45762,897.0,9150
2021-04-07 15:00:00,Unknown,2467,97738,1327.0,47089,1361.0,10511
2021-04-08 15:00:00,Unknown,3094,100832,1507.0,48596,1523.0,12034
2021-04-09 15:00:00,Unknown,3337,104169,1081.0,49677,1296.0,13330
2021-04-10 15:00:00,Unknown,2800,106969,1063.0,50740,1006.0,14336
2021-04-11 15:00:00,Unknown,2518,109487,1077.0,51817,870.0,15206
2021-04-12 15:00:00,Unknown,2848,112335,1880.0,53697,1103.0,16309
2021-04-13 15:00:00,Unknown,3360,115695,1904.0,55601,32.0,16341
2021-04-14 15:00:00,Unknown,3198,118893,2183.0,57784,10.0,16351
2021-04-15 15:00:00,Unknown,3837,122730,2325.0,60109,14.0,16365
2021-04-16 15:00:00,Unknown,3427,126157,2397.0,62506,1.0,16366
2021-04-17 15:00:00,Unknown,3722,129879,1671.0,64177,1.0,16367
2021-04-18 15:00:00,Unknown,2994,132873,1717.0,65894,,16367
2021-04-19 15:00:00,Unknown,2853,135726,2439.0,68333,3.0,16370
2021-04-20 15:00:00,Unknown,2309,138035,2184.0,70517,,16370
2021-04-21 15:00:00,Unknown,3123,141158,2514.0,73031,,16370
2021-04-22 15:00:00,Unknown,2875,144033,1291.0,74322,,16370
2021-04-23 15:00:00,Unknown,3444,147477,1982.0,76304,2.0,16372
2021-04-24 15:00:00,Unknown,3277,150754,1556.0,77860,3.0,16375
2021-04-25 15:00:00,Unknown,2490,153244,774.0,78634,,16375
2021-04-26 15:00:00,Unknown,1913,155157,1525.0,80159,11.0,16386
2021-04-27 15:00:00,Unknown,2501,157658,1464.0,81623,80.0,16466
2021-04-28 15:00:00,Unknown,2244,159902,2576.0,84199,94.0,16560
2021-04-29 15:00:00,Unknown,2083,161985,2711.0,86910,78.0,16638
2021-04-30 15:00:00,Unknown,2224,164209,2792.0,89702,113.0,16751
2021-05-01 15:00:00,Unknown,1722,165931,2622.0,92324,58.0,16809
2021-05-02 15:00:00,Unknown,1346,167277,2272.0,94596,38.0,16847
2021-05-03 15:00:00,Unknown,921,168198,2795.0,97391,92.0,16939
2021-05-04 15:00:00,Unknown,892,169090,3050.0,100441,104.0,17043
2021-05-05 15:00:00,Unknown,1551,170641,2976.0,103417,117.0,17160
2021-05-06 15:00:00,Unknown,1370,172011,3334.0,106751,91.0,17251
2021-05-07 15:00:00,Unknown,1452,173463,2860.0,109611,105.0,17356
2021-05-08 15:00:00,Unknown,1118,174581,3203.0,112814,109.0,17465
2021-05-09 15:00:00,Unknown,735,175316,1562.0,114376,36.0,17501
2021-05-10 15:00:00,Unknown,727,176043,2911.0,117287,72.0,17573
2021-05-11 15:00:00,Unknown,857,176900,2329.0,119616,80.0,17653
2021-05-12 15:00:00,Unknown,1014,177914,2750.0,122366,156.0,17809
2021-05-13 15:00:00,Unknown,1246,179160,2381.0,124747,144.0,17953
2021-05-14 15:00:00,Unknown,1385,180545,2398.0,127145,186.0,18139
2021-05-15 15:00:00,Unknown,1602,182147,2497.0,129642,237.0,18376
2021-05-16 15:00:00,Unknown,633,182780,2157.0,131799,202.0,18578
2021-05-17 15:00:00,Unknown,824,183604,1698.0,133497,230.0,18808
2021-05-18 15:00:00,Unknown,1429,185033,2563.0,136060,214.0,19022
2021-05-19 15:00:00,Unknown,1446,186479,2401.0,138461,168.0,19190
2021-05-20 15:00:00,Unknown,911,187390,1806.0,140267,175.0,19365
2020-12-14 15:00:00,Not Hispanic or Latino,2,2,,0,,0
2020-12-15 15:00:00,Not Hispanic or Latino,13,15,1.0,1,,0
2020-12-16 15:00:00,Not Hispanic or Latino,520,535,2.0,3,,0
2020-12-17 15:00:00,Not Hispanic or Latino,1009,1544,,3,,0
2021-01-14 15:00:00,Hispanic or Latino,746,8915,63.0,784,,0
2021-01-15 15:00:00,Hispanic or Latino,873,9788,64.0,848,,0
2021-01-16 15:00:00,Hispanic or Latino,181,9969,43.0,891,,0
2021-01-17 15:00:00,Hispanic or Latino,99,10068,38.0,929,,0
2021-01-18 15:00:00,Hispanic or Latino,169,10237,110.0,1039,,0
2021-01-19 15:00:00,Hispanic or Latino,456,10693,146.0,1185,,0
2021-01-20 15:00:00,Hispanic or Latino,617,11310,172.0,1357,,0
2021-01-21 15:00:00,Hispanic or Latino,752,12062,113.0,1470,,0
2021-01-22 15:00:00,Hispanic or Latino,952,13014,101.0,1571,,0
2021-01-23 15:00:00,Hispanic or Latino,329,13343,49.0,1620,,0
2021-01-24 15:00:00,Hispanic or Latino,98,13441,37.0,1657,,0
2021-01-25 15:00:00,Hispanic or Latino,371,13812,301.0,1958,,0
2021-01-26 15:00:00,Hispanic or Latino,501,14313,225.0,2183,,0
2021-01-27 15:00:00,Hispanic or Latino,744,15057,430.0,2613,,0
2021-01-28 15:00:00,Hispanic or Latino,790,15847,387.0,3000,,0
2021-01-29 15:00:00,Hispanic or Latino,686,16533,289.0,3289,,0
2021-01-30 15:00:00,Hispanic or Latino,481,17014,89.0,3378,,0
2021-01-31 15:00:00,Hispanic or Latino,131,17145,27.0,3405,,0
2021-02-01 15:00:00,Hispanic or Latino,161,17306,146.0,3551,,0
2021-02-02 15:00:00,Hispanic or Latino,413,17719,589.0,4140,,0
2021-02-03 15:00:00,Hispanic or Latino,607,18326,669.0,4809,,0
2021-02-04 15:00:00,Hispanic or Latino,721,19047,709.0,5518,,0
2021-02-05 15:00:00,Hispanic or Latino,753,19800,869.0,6387,,0
2021-02-06 15:00:00,Hispanic or Latino,383,20183,202.0,6589,,0
2021-02-07 15:00:00,Hispanic or Latino,168,20351,59.0,6648,,0
2021-02-08 15:00:00,Hispanic or Latino,522,20873,585.0,7233,,0
2021-02-09 15:00:00,Hispanic or Latino,547,21420,511.0,7744,,0
2021-02-10 15:00:00,Hispanic or Latino,694,22114,679.0,8423,,0
2021-02-11 15:00:00,Hispanic or Latino,860,22974,720.0,9143,,0
2021-02-12 15:00:00,Hispanic or Latino,761,23735,843.0,9986,,0
2021-02-13 15:00:00,Hispanic or Latino,364,24099,223.0,10209,,0
2021-02-14 15:00:00,Hispanic or Latino,275,24374,63.0,10272,,0
2021-02-15 15:00:00,Hispanic or Latino,318,24692,359.0,10631,,0
2021-02-16 15:00:00,Hispanic or Latino,502,25194,541.0,11172,,0
2021-02-17 15:00:00,Hispanic or Latino,692,25886,734.0,11906,,0
2021-02-18 15:00:00,Hispanic or Latino,115,26001,126.0,12032,,0
2021-02-19 15:00:00,Hispanic or Latino,378,26379,746.0,12778,,0
2021-02-20 15:00:00,Hispanic or Latino,369,26748,623.0,13401,,0
2021-02-21 15:00:00,Hispanic or Latino,308,27056,238.0,13639,,0
2021-02-22 15:00:00,Hispanic or Latino,291,27347,405.0,14044,,0
2021-02-23 15:00:00,Hispanic or Latino,520,27867,479.0,14523,,0
2021-02-24 15:00:00,Hispanic or Latino,560,28427,801.0,15324,,0
2021-02-25 15:00:00,Hispanic or Latino,770,29197,811.0,16135,,0
2021-02-26 15:00:00,Hispanic or Latino,1107,30304,833.0,16968,,0
2021-02-27 15:00:00,Hispanic or Latino,659,30963,336.0,17304,,0
2021-02-28 15:00:00,Hispanic or Latino,715,31678,176.0,17480,,0
2021-03-01 15:00:00,Hispanic or Latino,1104,32782,407.0,17887,,0
2021-03-02 15:00:00,Hispanic or Latino,1041,33823,339.0,18226,,0
2021-03-03 15:00:00,Hispanic or Latino,1136,34959,643.0,18869,13.0,13
2021-03-04 15:00:00,Hispanic or Latino,1339,36298,479.0,19348,150.0,163
2021-03-05 15:00:00,Hispanic or Latino,1629,37927,597.0,19945,200.0,363
2021-03-06 15:00:00,Hispanic or Latino,890,38817,277.0,20222,384.0,747
2021-03-07 15:00:00,Hispanic or Latino,569,39386,196.0,20418,287.0,1034
2021-03-08 15:00:00,Hispanic or Latino,1192,40578,298.0,20716,362.0,1396
2021-03-09 15:00:00,Hispanic or Latino,1214,41792,480.0,21196,435.0,1831
2021-03-10 15:00:00,Hispanic or Latino,1356,43148,613.0,21809,520.0,2351
2021-03-11 15:00:00,Hispanic or Latino,1517,44665,660.0,22469,252.0,2603
2021-03-12 15:00:00,Hispanic or Latino,2061,46726,648.0,23117,217.0,2820
2021-03-13 15:00:00,Hispanic or Latino,1213,47939,385.0,23502,211.0,3031
2021-03-14 15:00:00,Hispanic or Latino,1519,49458,207.0,23709,108.0,3139
2021-03-15 15:00:00,Hispanic or Latino,1759,51217,336.0,24045,42.0,3181
2021-03-16 15:00:00,Hispanic or Latino,2029,53246,412.0,24457,21.0,3202
2021-03-17 15:00:00,Hispanic or Latino,2462,55708,571.0,25028,59.0,3261
2021-03-18 15:00:00,Hispanic or Latino,2590,58298,387.0,25415,99.0,3360
2021-03-19 15:00:00,Hispanic or Latino,2602,60900,523.0,25938,83.0,3443
2021-03-20 15:00:00,Hispanic or Latino,2111,63011,411.0,26349,45.0,3488
2021-03-21 15:00:00,Hispanic or Latino,1611,64622,439.0,26788,13.0,3501
2021-03-22 15:00:00,Hispanic or Latino,2201,66823,429.0,27217,31.0,3532
2021-03-23 15:00:00,Hispanic or Latino,2610,69433,607.0,27824,134.0,3666
2021-03-24 15:00:00,Hispanic or Latino,3185,72618,819.0,28643,203.0,3869
2021-03-25 15:00:00,Hispanic or Latino,3329,75947,820.0,29463,113.0,3982
2021-03-26 15:00:00,Hispanic or Latino,2484,78431,1230.0,30693,200.0,4182
2021-03-27 15:00:00,Hispanic or Latino,2217,80648,803.0,31496,137.0,4319
2021-03-28 15:00:00,Hispanic or Latino,1112,81760,531.0,32027,70.0,4389
2021-03-29 15:00:00,Hispanic or Latino,1991,83751,1205.0,33232,59.0,4448
2021-03-30 15:00:00,Hispanic or Latino,2708,86459,1165.0,34397,108.0,4556
2021-03-31 15:00:00,Hispanic or Latino,3382,89841,1317.0,35714,384.0,4940
2021-04-01 15:00:00,Hispanic or Latino,2847,92688,1644.0,37358,291.0,5231
2021-04-02 15:00:00,Hispanic or Latino,2740,95428,1855.0,39213,328.0,5559
2021-04-03 15:00:00,Hispanic or Latino,2107,97535,979.0,40192,274.0,5833
2021-04-04 15:00:00,Hispanic or Latino,692,98227,562.0,40754,47.0,5880
2021-04-05 15:00:00,Hispanic or Latino,2280,100507,1492.0,42246,358.0,6238
2021-04-06 15:00:00,Hispanic or Latino,3100,103607,1769.0,44015,510.0,6748
2021-04-07 15:00:00,Hispanic or Latino,3532,107139,1712.0,45727,844.0,7592
2021-04-08 15:00:00,Hispanic or Latino,3311,110450,1887.0,47614,1201.0,8793
2021-04-09 15:00:00,Hispanic or Latino,3221,113671,2170.0,49784,1091.0,9884
2021-04-10 15:00:00,Hispanic or Latino,2193,115864,1554.0,51338,603.0,10487
2021-04-11 15:00:00,Hispanic or Latino,2140,118004,1303.0,52641,640.0,11127
2021-04-12 15:00:00,Hispanic or Latino,2136,120140,2087.0,54728,775.0,11902
2021-04-13 15:00:00,Hispanic or Latino,3619,123759,2488.0,57216,30.0,11932
2021-04-14 15:00:00,Hispanic or Latino,4410,128169,2568.0,59784,35.0,11967
2021-04-15 15:00:00,Hispanic or Latino,3660,131829,2226.0,62010,25.0,11992
2021-04-16 15:00:00,Hispanic or Latino,3717,135546,2794.0,64804,,11992
2021-04-17 15:00:00,Hispanic or Latino,3664,139210,1819.0,66623,,11992
2021-04-18 15:00:00,Hispanic or Latino,2355,141565,1181.0,67804,,11992
2021-04-19 15:00:00,Hispanic or Latino,3349,144914,1874.0,69678,4.0,11996
2021-04-20 15:00:00,Hispanic or Latino,3543,148457,2402.0,72080,,11996
2021-04-21 15:00:00,Hispanic or Latino,4927,153384,3052.0,75132,,11996
2021-04-22 15:00:00,Hispanic or Latino,3914,157298,3115.0,78247,,11996
2021-04-23 15:00:00,Hispanic or Latino,3603,160901,2993.0,81240,,11996
2021-04-24 15:00:00,Hispanic or Latino,4284,165185,2543.0,83783,6.0,12002
2021-04-25 15:00:00,Hispanic or Latino,2850,168035,809.0,84592,3.0,12005
2021-04-26 15:00:00,Hispanic or Latino,3509,171544,2372.0,86964,15.0,12020
2021-04-27 15:00:00,Hispanic or Latino,3496,175040,2546.0,89510,113.0,12133
2021-04-28 15:00:00,Hispanic or Latino,3585,178625,3579.0,93089,142.0,12275
2021-04-29 15:00:00,Hispanic or Latino,3479,182104,3029.0,96118,151.0,12426
2021-04-30 15:00:00,Hispanic or Latino,4035,186139,2680.0,98798,169.0,12595
2021-05-01 15:00:00,Hispanic or Latino,3356,189495,2193.0,100991,129.0,12724
2021-05-02 15:00:00,Hispanic or Latino,1578,191073,1583.0,102574,126.0,12850
2021-05-03 15:00:00,Hispanic or Latino,1890,192963,2153.0,104727,238.0,13088
2021-05-04 15:00:00,Hispanic or Latino,1818,194781,3074.0,107801,175.0,13263
2021-05-05 15:00:00,Hispanic or Latino,2780,197561,3720.0,111521,217.0,13480
2021-05-06 15:00:00,Hispanic or Latino,2135,199696,3382.0,114903,165.0,13645
2021-05-07 15:00:00,Hispanic or Latino,2925,202621,3352.0,118255,191.0,13836
2021-05-08 15:00:00,Hispanic or Latino,1968,204589,3108.0,121363,173.0,14009
2021-05-09 15:00:00,Hispanic or Latino,933,205522,1428.0,122791,100.0,14109
2021-05-10 15:00:00,Hispanic or Latino,1272,206794,3027.0,125818,134.0,14243
2021-05-11 15:00:00,Hispanic or Latino,1716,208510,2961.0,128779,153.0,14396
2021-05-12 15:00:00,Hispanic or Latino,2215,210725,4139.0,132918,332.0,14728
2021-05-13 15:00:00,Hispanic or Latino,2406,213131,3368.0,136286,118.0,14846
2021-05-14 15:00:00,Hispanic or Latino,3256,216387,2810.0,139096,184.0,15030
2021-05-15 15:00:00,Hispanic or Latino,2958,219345,3121.0,142217,226.0,15256
2021-05-16 15:00:00,Hispanic or Latino,1360,220705,2222.0,144439,198.0,15454
2021-05-17 15:00:00,Hispanic or Latino,1861,222566,2996.0,147435,188.0,15642
2021-05-18 15:00:00,Hispanic or Latino,2628,225194,3622.0,151057,215.0,15857
2021-05-19 15:00:00,Hispanic or Latino,3064,228258,3142.0,154199,192.0,16049
2021-05-20 15:00:00,Hispanic or Latino,884,229142,1488.0,155687,120.0,16169
2020-12-18 15:00:00,Not Hispanic or Latino,2696,4240,2.0,5,,0
2020-12-19 15:00:00,Not Hispanic or Latino,793,5033,1.0,6,,0
2020-12-20 15:00:00,Not Hispanic or Latino,246,5279,2.0,8,,0
2020-12-21 15:00:00,Not Hispanic or Latino,3508,8787,3.0,11,,0
2020-12-22 15:00:00,Not Hispanic or Latino,5520,14307,1.0,12,,0
2020-12-23 15:00:00,Not Hispanic or Latino,5106,19413,9.0,21,,0
2020-12-24 15:00:00,Not Hispanic or Latino,2494,21907,4.0,25,,0
2020-12-25 15:00:00,Not Hispanic or Latino,811,22718,2.0,27,,0
2020-12-26 15:00:00,Not Hispanic or Latino,1425,24143,3.0,30,,0
2020-12-27 15:00:00,Not Hispanic or Latino,1571,25714,4.0,34,,0
2020-12-28 15:00:00,Not Hispanic or Latino,8087,33801,9.0,43,,0
2020-12-29 15:00:00,Not Hispanic or Latino,9552,43353,7.0,50,,0
2020-12-30 15:00:00,Not Hispanic or Latino,11330,54683,16.0,66,,0
2020-12-31 15:00:00,Not Hispanic or Latino,6807,61490,9.0,75,,0
2021-01-01 15:00:00,Not Hispanic or Latino,1451,62941,29.0,104,,0
2021-01-02 15:00:00,Not Hispanic or Latino,2387,65328,21.0,125,,0
2021-01-03 15:00:00,Not Hispanic or Latino,2829,68157,62.0,187,,0
2021-01-04 15:00:00,Not Hispanic or Latino,11657,79814,237.0,424,,0
2021-01-05 15:00:00,Not Hispanic or Latino,10890,90704,407.0,831,,0
2021-01-06 15:00:00,Not Hispanic or Latino,13454,104158,732.0,1563,,0
2021-01-07 15:00:00,Not Hispanic or Latino,13433,117591,1487.0,3050,,0
2021-01-08 15:00:00,Not Hispanic or Latino,14445,132036,2401.0,5451,,0
2021-01-09 15:00:00,Not Hispanic or Latino,4449,136485,799.0,6250,,0
2021-01-10 15:00:00,Not Hispanic or Latino,2440,138925,310.0,6560,,0
2021-01-11 15:00:00,Not Hispanic or Latino,12448,151373,3059.0,9619,,0
2021-01-12 15:00:00,Not Hispanic or Latino,15499,166872,4783.0,14402,,0
2021-01-13 15:00:00,Not Hispanic or Latino,16922,183794,3438.0,17840,,0
2021-01-14 15:00:00,Not Hispanic or Latino,16278,200072,1711.0,19551,,0
2021-01-15 15:00:00,Not Hispanic or Latino,17563,217635,1573.0,21124,,0
2021-01-16 15:00:00,Not Hispanic or Latino,5015,222650,1316.0,22440,,0
2021-01-17 15:00:00,Not Hispanic or Latino,1895,224545,1188.0,23628,,0
2021-01-18 15:00:00,Not Hispanic or Latino,6779,231324,2575.0,26203,,0
2021-01-19 15:00:00,Not Hispanic or Latino,15687,247011,4271.0,30474,,0
2021-01-20 15:00:00,Not Hispanic or Latino,19583,266594,4489.0,34963,,0
2021-01-21 15:00:00,Not Hispanic or Latino,21811,288405,3089.0,38052,,0
2021-01-22 15:00:00,Not Hispanic or Latino,26647,315052,2998.0,41050,,0
2021-01-23 15:00:00,Not Hispanic or Latino,8750,323802,1343.0,42393,,0
2021-01-24 15:00:00,Not Hispanic or Latino,2984,326786,1374.0,43767,,0
2021-01-25 15:00:00,Not Hispanic or Latino,15323,342109,7313.0,51080,,0
2021-01-26 15:00:00,Not Hispanic or Latino,16203,358312,7862.0,58942,,0
2021-01-27 15:00:00,Not Hispanic or Latino,22822,381134,11079.0,70021,,0
2021-01-28 15:00:00,Not Hispanic or Latino,21083,402217,8281.0,78302,,0
2021-01-29 15:00:00,Not Hispanic or Latino,22535,424752,6475.0,84777,,0
2021-01-30 15:00:00,Not Hispanic or Latino,16701,441453,2169.0,86946,,0
2021-01-31 15:00:00,Not Hispanic or Latino,3180,444633,1103.0,88049,,0
2021-02-01 15:00:00,Not Hispanic or Latino,5927,450560,3828.0,91877,,0
2021-02-02 15:00:00,Not Hispanic or Latino,10829,461389,12028.0,103905,,0
2021-02-03 15:00:00,Not Hispanic or Latino,16243,477632,16422.0,120327,,0
2021-02-04 15:00:00,Not Hispanic or Latino,20090,497722,14093.0,134420,,0
2021-02-05 15:00:00,Not Hispanic or Latino,18459,516181,15636.0,150056,,0
2021-02-06 15:00:00,Not Hispanic or Latino,10234,526415,5758.0,155814,,0
2021-02-07 15:00:00,Not Hispanic or Latino,5272,531687,1491.0,157305,,0
2021-02-08 15:00:00,Not Hispanic or Latino,11380,543067,11576.0,168881,,0
2021-02-09 15:00:00,Not Hispanic or Latino,15067,558134,12449.0,181330,,0
2021-02-10 15:00:00,Not Hispanic or Latino,17532,575666,19579.0,200909,,0
2021-02-11 15:00:00,Not Hispanic or Latino,20984,596650,15721.0,216630,,0
2021-02-12 15:00:00,Not Hispanic or Latino,18364,615014,17690.0,234320,,0
2021-02-13 15:00:00,Not Hispanic or Latino,10274,625288,5594.0,239914,,0
2021-02-14 15:00:00,Not Hispanic or Latino,6271,631559,1767.0,241681,,0
2021-02-15 15:00:00,Not Hispanic or Latino,10633,642192,11574.0,253255,,0
2021-02-16 15:00:00,Not Hispanic or Latino,15206,657398,19287.0,272542,,0
2021-02-17 15:00:00,Not Hispanic or Latino,19016,676414,24547.0,297089,,0
2021-02-18 15:00:00,Not Hispanic or Latino,2813,679227,3860.0,300949,,0
2021-02-19 15:00:00,Not Hispanic or Latino,9758,688985,17740.0,318689,,0
2021-02-20 15:00:00,Not Hispanic or Latino,9235,698220,18756.0,337445,,0
2021-02-21 15:00:00,Not Hispanic or Latino,5419,703639,6754.0,344199,,0
2021-02-22 15:00:00,Not Hispanic or Latino,7312,710951,14086.0,358285,,0
2021-02-23 15:00:00,Not Hispanic or Latino,14285,725236,14468.0,372753,,0
2021-02-24 15:00:00,Not Hispanic or Latino,16596,741832,22930.0,395683,,0
2021-02-25 15:00:00,Not Hispanic or Latino,18697,760529,24438.0,420121,,0
2021-02-26 15:00:00,Not Hispanic or Latino,24532,785061,23888.0,444009,,0
2021-02-27 15:00:00,Not Hispanic or Latino,14496,799557,10226.0,454235,,0
2021-02-28 15:00:00,Not Hispanic or Latino,14055,813612,4101.0,458336,,0
2021-03-01 15:00:00,Not Hispanic or Latino,22319,835931,10459.0,468795,,0
2021-03-02 15:00:00,Not Hispanic or Latino,21521,857452,11824.0,480619,14.0,14
2021-03-03 15:00:00,Not Hispanic or Latino,27238,884690,16541.0,497160,131.0,145
2021-03-04 15:00:00,Not Hispanic or Latino,28131,912821,16519.0,513679,3806.0,3951
2021-03-05 15:00:00,Not Hispanic or Latino,25753,938574,17549.0,531228,4557.0,8508
2021-03-06 15:00:00,Not Hispanic or Latino,15969,954543,8040.0,539268,5377.0,13885
2021-03-07 15:00:00,Not Hispanic or Latino,10760,965303,3985.0,543253,5975.0,19860
2021-03-08 15:00:00,Not Hispanic or Latino,23238,988541,7757.0,551010,7454.0,27314
2021-03-09 15:00:00,Not Hispanic or Latino,23527,1012068,14012.0,565022,7437.0,34751
2021-03-10 15:00:00,Not Hispanic or Latino,26972,1039040,14382.0,579404,6878.0,41629
2021-03-11 15:00:00,Not Hispanic or Latino,31138,1070178,14767.0,594171,3419.0,45048
2021-03-12 15:00:00,Not Hispanic or Latino,33374,1103552,16035.0,610206,2434.0,47482
2021-03-13 15:00:00,Not Hispanic or Latino,20422,1123974,9094.0,619300,1211.0,48693
2021-03-14 15:00:00,Not Hispanic or Latino,15094,1139068,5944.0,625244,783.0,49476
2021-03-15 15:00:00,Not Hispanic or Latino,25868,1164936,10104.0,635348,472.0,49948
2021-03-16 15:00:00,Not Hispanic or Latino,29281,1194217,12064.0,647412,692.0,50640
2021-03-17 15:00:00,Not Hispanic or Latino,32948,1227165,15205.0,662617,1018.0,51658
2021-03-18 15:00:00,Not Hispanic or Latino,36441,1263606,11146.0,673763,1137.0,52795
2021-03-19 15:00:00,Not Hispanic or Latino,33408,1297014,13931.0,687694,873.0,53668
2021-03-20 15:00:00,Not Hispanic or Latino,20720,1317734,8870.0,696564,584.0,54252
2021-03-21 15:00:00,Not Hispanic or Latino,16076,1333810,6573.0,703137,272.0,54524
2021-03-22 15:00:00,Not Hispanic or Latino,28340,1362150,10021.0,713158,752.0,55276
2021-03-23 15:00:00,Not Hispanic or Latino,32636,1394786,15499.0,728657,1294.0,56570
2021-03-24 15:00:00,Not Hispanic or Latino,34758,1429544,19075.0,747732,1069.0,57639
2021-03-25 15:00:00,Not Hispanic or Latino,35904,1465448,18791.0,766523,2004.0,59643
2021-03-26 15:00:00,Not Hispanic or Latino,31283,1496731,23251.0,789774,1931.0,61574
2021-03-27 15:00:00,Not Hispanic or Latino,22720,1519451,15075.0,804849,1837.0,63411
2021-03-28 15:00:00,Not Hispanic or Latino,13885,1533336,11259.0,816108,1107.0,64518
2021-03-29 15:00:00,Not Hispanic or Latino,24891,1558227,23422.0,839530,985.0,65503
2021-03-30 15:00:00,Not Hispanic or Latino,34205,1592432,25987.0,865517,1594.0,67097
2021-03-31 15:00:00,Not Hispanic or Latino,34675,1627107,31513.0,897030,4512.0,71609
2021-04-01 15:00:00,Not Hispanic or Latino,35773,1662880,33708.0,930738,4514.0,76123
2021-04-02 15:00:00,Not Hispanic or Latino,29796,1692676,28334.0,959072,4670.0,80793
2021-04-03 15:00:00,Not Hispanic or Latino,17635,1710311,16327.0,975399,3369.0,84162
2021-04-04 15:00:00,Not Hispanic or Latino,6977,1717288,8628.0,984027,817.0,84979
2021-04-05 15:00:00,Not Hispanic or Latino,23352,1740640,25520.0,1009547,5544.0,90523
2021-04-06 15:00:00,Not Hispanic or Latino,34150,1774790,26581.0,1036128,9026.0,99549
2021-04-07 15:00:00,Not Hispanic or Latino,29554,1804344,30198.0,1066326,10445.0,109994
2021-04-08 15:00:00,Not Hispanic or Latino,35437,1839781,31918.0,1098244,10932.0,120926
2021-04-09 15:00:00,Not Hispanic or Latino,27036,1866817,32232.0,1130476,12010.0,132936
2021-04-10 15:00:00,Not Hispanic or Latino,18228,1885045,20046.0,1150522,5922.0,138858
2021-04-11 15:00:00,Not Hispanic or Latino,12791,1897836,10681.0,1161203,8549.0,147407
2021-04-12 15:00:00,Not Hispanic or Latino,19226,1917062,28540.0,1189743,8958.0,156365
2021-04-13 15:00:00,Not Hispanic or Latino,35318,1952380,31308.0,1221051,275.0,156640
2021-04-14 15:00:00,Not Hispanic or Latino,32334,1984714,32275.0,1253326,156.0,156796
2021-04-15 15:00:00,Not Hispanic or Latino,33044,2017758,32878.0,1286204,108.0,156904
2021-04-16 15:00:00,Not Hispanic or Latino,28953,2046711,31773.0,1317977,9.0,156913
2021-04-17 15:00:00,Not Hispanic or Latino,24140,2070851,16871.0,1334848,4.0,156917
2021-04-18 15:00:00,Not Hispanic or Latino,14217,2085068,12887.0,1347735,3.0,156920
2021-04-19 15:00:00,Not Hispanic or Latino,21918,2106986,29317.0,1377052,46.0,156966
2021-04-20 15:00:00,Not Hispanic or Latino,22770,2129756,35502.0,1412554,33.0,156999
2021-04-21 15:00:00,Not Hispanic or Latino,28450,2158206,36076.0,1448630,15.0,157014
2021-04-22 15:00:00,Not Hispanic or Latino,27779,2185985,34197.0,1482827,15.0,157029
2021-04-23 15:00:00,Not Hispanic or Latino,23699,2209684,32617.0,1515444,10.0,157039
2021-04-24 15:00:00,Not Hispanic or Latino,18671,2228355,23300.0,1538744,63.0,157102
2021-04-25 15:00:00,Not Hispanic or Latino,13825,2242180,6596.0,1545340,21.0,157123
2021-04-26 15:00:00,Not Hispanic or Latino,19647,2261827,25852.0,1571192,177.0,157300
2021-04-27 15:00:00,Not Hispanic or Latino,20314,2282141,27966.0,1599158,899.0,158199
2021-04-28 15:00:00,Not Hispanic or Latino,22110,2304251,31447.0,1630605,1118.0,159317
2021-04-29 15:00:00,Not Hispanic or Latino,20646,2324897,31035.0,1661640,1194.0,160511
2021-04-30 15:00:00,Not Hispanic or Latino,20768,2345665,25071.0,1686711,1314.0,161825
2021-05-01 15:00:00,Not Hispanic or Latino,12837,2358502,17654.0,1704365,767.0,162592
2021-05-02 15:00:00,Not Hispanic or Latino,6239,2364741,11055.0,1715420,627.0,163219
2021-05-03 15:00:00,Not Hispanic or Latino,9877,2374618,21319.0,1736739,1562.0,164781
2021-05-04 15:00:00,Not Hispanic or Latino,10802,2385420,31155.0,1767894,1434.0,166215
2021-05-05 15:00:00,Not Hispanic or Latino,13611,2399031,28300.0,1796194,1556.0,167771
2021-05-06 15:00:00,Not Hispanic or Latino,13095,2412126,31076.0,1827270,1418.0,169189
2021-05-07 15:00:00,Not Hispanic or Latino,12444,2424570,26797.0,1854067,1606.0,170795
2021-05-08 15:00:00,Not Hispanic or Latino,7033,2431603,22529.0,1876596,991.0,171786
2021-05-09 15:00:00,Not Hispanic or Latino,3450,2435053,8254.0,1884850,553.0,172339
2021-05-10 15:00:00,Not Hispanic or Latino,6427,2441480,22351.0,1907201,1050.0,173389
2021-05-11 15:00:00,Not Hispanic or Latino,8898,2450378,22810.0,1930011,1149.0,174538
2021-05-12 15:00:00,Not Hispanic or Latino,10734,2461112,28701.0,1958712,1345.0,175883
2021-05-13 15:00:00,Not Hispanic or Latino,17562,2478674,26236.0,1984948,1046.0,176929
2021-05-14 15:00:00,Not Hispanic or Latino,18619,2497293,21546.0,2006494,1367.0,178296
2021-05-15 15:00:00,Not Hispanic or Latino,15947,2513240,16736.0,2023230,943.0,179239
2021-05-16 15:00:00,Not Hispanic or Latino,6571,2519811,12250.0,2035480,692.0,179931
2021-05-17 15:00:00,Not Hispanic or Latino,13426,2533237,19525.0,2055005,1405.0,181336
2021-05-18 15:00:00,Not Hispanic or Latino,16038,2549275,22237.0,2077242,1435.0,182771
2021-05-19 15:00:00,Not Hispanic or Latino,17813,2567088,19033.0,2096275,950.0,183721
2021-05-20 15:00:00,Not Hispanic or Latino,6122,2573210,10640.0,2106915,675.0,184396
