VACCINATION_DATE,Ethnicity,FirstDoseDaily,FirstDoseCumulative,SecondDoseDaily,SecondDoseCumulative,SingleDoseDaily,SingleDoseCumulative
2020-12-14 15:00:00,Unknown,1,1,,0,,0
2020-12-16 15:00:00,Unknown,10,11,,0,,0
2020-12-17 15:00:00,Unknown,16,27,,0,,0
2020-12-18 15:00:00,Unknown,88,115,,0,,0
2020-12-19 15:00:00,Unknown,27,142,,0,,0
2020-12-20 15:00:00,Unknown,32,174,,0,,0
2020-12-21 15:00:00,Unknown,70,244,,0,,0
2020-12-22 15:00:00,Unknown,434,678,,0,,0
2020-12-23 15:00:00,Unknown,190,868,,0,,0
2020-12-24 15:00:00,Unknown,61,929,,0,,0
2020-12-25 15:00:00,Unknown,189,1118,,0,,0
2020-12-26 15:00:00,Unknown,203,1321,,0,,0
2020-12-27 15:00:00,Unknown,141,1462,,0,,0
2020-12-28 15:00:00,Unknown,290,1752,,0,,0
2020-12-29 15:00:00,Unknown,487,2239,,0,,0
2020-12-30 15:00:00,Unknown,360,2599,,0,,0
2020-12-31 15:00:00,Unknown,207,2806,2.0,2,,0
2021-01-01 15:00:00,Unknown,159,2965,1.0,3,,0
2021-01-02 15:00:00,Unknown,193,3158,2.0,5,,0
2021-01-03 15:00:00,Unknown,258,3416,4.0,9,,0
2021-01-04 15:00:00,Unknown,688,4104,6.0,15,,0
2021-01-05 15:00:00,Unknown,528,4632,17.0,32,,0
2021-01-06 15:00:00,Unknown,668,5300,22.0,54,,0
2021-01-07 15:00:00,Unknown,425,5725,55.0,109,,0
2021-01-08 15:00:00,Unknown,8303,14028,74.0,183,,0
2021-01-09 15:00:00,Unknown,214,14242,40.0,223,,0
2021-01-10 15:00:00,Unknown,184,14426,11.0,234,,0
2021-01-11 15:00:00,Unknown,319,14745,79.0,313,,0
2021-01-12 15:00:00,Unknown,705,15450,356.0,669,,0
2021-01-13 15:00:00,Unknown,416,15866,133.0,802,,0
2021-01-14 15:00:00,Unknown,387,16253,59.0,861,,0
2021-01-15 15:00:00,Unknown,542,16795,181.0,1042,,0
2021-01-16 15:00:00,Unknown,324,17119,165.0,1207,,0
2021-01-17 15:00:00,Unknown,112,17231,105.0,1312,,0
2021-01-18 15:00:00,Unknown,184,17415,221.0,1533,,0
2021-01-19 15:00:00,Unknown,302,17717,250.0,1783,,0
2021-01-20 15:00:00,Unknown,329,18046,153.0,1936,,0
2021-01-21 15:00:00,Unknown,343,18389,72.0,2008,,0
2021-01-22 15:00:00,Unknown,726,19115,213.0,2221,,0
2021-01-23 15:00:00,Unknown,428,19543,163.0,2384,,0
2021-01-24 15:00:00,Unknown,218,19761,170.0,2554,,0
2021-01-25 15:00:00,Unknown,565,20326,506.0,3060,,0
2021-01-26 15:00:00,Unknown,647,20973,363.0,3423,,0
2021-01-27 15:00:00,Unknown,514,21487,566.0,3989,,0
2021-01-28 15:00:00,Unknown,483,21970,273.0,4262,,0
2021-01-29 15:00:00,Unknown,348,22318,174.0,4436,,0
2021-01-30 15:00:00,Unknown,297,22615,48.0,4484,,0
2021-01-31 15:00:00,Unknown,359,22974,86.0,4570,,0
2021-02-01 15:00:00,Unknown,412,23386,182.0,4752,,0
2021-02-02 15:00:00,Unknown,529,23915,623.0,5375,,0
2021-02-03 15:00:00,Unknown,673,24588,496.0,5871,,0
2021-02-04 15:00:00,Unknown,853,25441,402.0,6273,,0
2021-02-05 15:00:00,Unknown,655,26096,417.0,6690,,0
2021-02-06 15:00:00,Unknown,396,26492,8215.0,14905,,0
2021-02-07 15:00:00,Unknown,395,26887,90.0,14995,,0
2021-04-13 15:00:00,Federal Entities,84295,84295,54201.0,54201,2952.0,2952
2021-04-14 15:00:00,Federal Entities,557,84852,11.0,54212,1.0,2953
2021-04-15 15:00:00,Federal Entities,623,85475,823.0,55035,19.0,2972
2021-04-16 15:00:00,Federal Entities,782,86257,1016.0,56051,8.0,2980
2021-04-17 15:00:00,Federal Entities,1136,87393,1177.0,57228,6.0,2986
2021-04-19 15:00:00,Federal Entities,1369,88762,2003.0,59231,9.0,2995
2021-04-20 15:00:00,Federal Entities,3243,92005,2158.0,61389,19.0,3014
2021-04-21 15:00:00,Federal Entities,906,92911,1206.0,62595,4.0,3018
2021-04-22 15:00:00,Federal Entities,1018,93929,458.0,63053,,3018
2021-04-23 15:00:00,Federal Entities,759,94688,632.0,63685,1.0,3019
2021-04-25 15:00:00,Federal Entities,992,95680,2492.0,66177,5.0,3024
2021-04-26 15:00:00,Federal Entities,1483,97163,1672.0,67849,1.0,3025
2021-04-29 15:00:00,Federal Entities,223,97386,865.0,68714,2.0,3027
2021-05-01 15:00:00,Federal Entities,1556,98942,1974.0,70688,14.0,3041
2021-05-02 15:00:00,Federal Entities,1071,100013,1875.0,72563,4.0,3045
2021-05-03 15:00:00,Federal Entities,403,100416,2165.0,74728,4.0,3049
2021-05-04 15:00:00,Federal Entities,28,100444,25.0,74753,,3049
2021-05-05 15:00:00,Federal Entities,365,100809,814.0,75567,,3049
2021-05-06 15:00:00,Federal Entities,275,101084,880.0,76447,3.0,3052
2021-05-07 15:00:00,Federal Entities,274,101358,966.0,77413,8.0,3060
2021-05-08 15:00:00,Federal Entities,297,101655,1312.0,78725,6.0,3066
2021-05-10 15:00:00,Federal Entities,338,101993,1712.0,80437,1.0,3067
2021-05-11 15:00:00,Federal Entities,18,102011,13.0,80450,,3067
2021-05-12 15:00:00,Federal Entities,243,102254,1124.0,81574,,3067
2021-05-14 15:00:00,Federal Entities,290,102544,1022.0,82596,2.0,3069
2020-12-15 15:00:00,Hispanic or Latino,2,2,,0,,0
2020-12-16 15:00:00,Hispanic or Latino,18,20,,0,,0
2020-12-17 15:00:00,Hispanic or Latino,32,52,,0,,0
2020-12-18 15:00:00,Hispanic or Latino,84,136,,0,,0
2020-12-19 15:00:00,Hispanic or Latino,33,169,,0,,0
2020-12-20 15:00:00,Hispanic or Latino,8,177,,0,,0
2020-12-21 15:00:00,Hispanic or Latino,148,325,1.0,1,,0
2020-12-22 15:00:00,Hispanic or Latino,251,576,,1,,0
2020-12-23 15:00:00,Hispanic or Latino,181,757,1.0,2,,0
2020-12-24 15:00:00,Hispanic or Latino,89,846,,2,,0
2020-12-25 15:00:00,Hispanic or Latino,37,883,,2,,0
2020-12-26 15:00:00,Hispanic or Latino,39,922,,2,,0
2020-12-27 15:00:00,Hispanic or Latino,58,980,,2,,0
2020-12-28 15:00:00,Hispanic or Latino,258,1238,1.0,3,,0
2020-12-29 15:00:00,Hispanic or Latino,360,1598,1.0,4,,0
2020-12-30 15:00:00,Hispanic or Latino,500,2098,2.0,6,,0
2020-12-31 15:00:00,Hispanic or Latino,311,2409,2.0,8,,0
2021-01-01 15:00:00,Hispanic or Latino,49,2458,2.0,10,,0
2021-01-02 15:00:00,Hispanic or Latino,80,2538,2.0,12,,0
2021-01-03 15:00:00,Hispanic or Latino,118,2656,3.0,15,,0
2021-01-04 15:00:00,Hispanic or Latino,606,3262,11.0,26,,0
2021-01-05 15:00:00,Hispanic or Latino,397,3659,18.0,44,,0
2021-01-06 15:00:00,Hispanic or Latino,576,4235,19.0,63,,0
2021-01-07 15:00:00,Hispanic or Latino,798,5033,55.0,118,,0
2021-01-08 15:00:00,Hispanic or Latino,867,5900,89.0,207,,0
2021-01-09 15:00:00,Hispanic or Latino,196,6096,31.0,238,,0
2021-01-10 15:00:00,Hispanic or Latino,133,6229,20.0,258,,0
2021-01-11 15:00:00,Hispanic or Latino,547,6776,126.0,384,,0
2021-01-12 15:00:00,Hispanic or Latino,726,7502,204.0,588,,0
2021-01-13 15:00:00,Hispanic or Latino,663,8165,130.0,718,,0
2021-01-14 15:00:00,Hispanic or Latino,744,8909,62.0,780,,0
2021-01-15 15:00:00,Hispanic or Latino,873,9782,64.0,844,,0
2021-01-16 15:00:00,Hispanic or Latino,183,9965,41.0,885,,0
2021-01-17 15:00:00,Hispanic or Latino,99,10064,38.0,923,,0
2021-01-18 15:00:00,Hispanic or Latino,171,10235,111.0,1034,,0
2021-02-08 15:00:00,Unknown,661,27548,251.0,15246,,0
2021-02-09 15:00:00,Unknown,739,28287,291.0,15537,,0
2021-02-10 15:00:00,Unknown,820,29107,402.0,15939,,0
2021-02-11 15:00:00,Unknown,905,30012,397.0,16336,,0
2021-02-12 15:00:00,Unknown,715,30727,553.0,16889,,0
2021-02-13 15:00:00,Unknown,385,31112,154.0,17043,,0
2021-02-14 15:00:00,Unknown,449,31561,147.0,17190,,0
2021-02-15 15:00:00,Unknown,471,32032,489.0,17679,,0
2021-02-16 15:00:00,Unknown,730,32762,671.0,18350,,0
2021-02-17 15:00:00,Unknown,838,33600,457.0,18807,,0
2021-02-18 15:00:00,Unknown,312,33912,226.0,19033,,0
2021-02-19 15:00:00,Unknown,642,34554,414.0,19447,,0
2021-02-20 15:00:00,Unknown,479,35033,354.0,19801,,0
2021-02-21 15:00:00,Unknown,341,35374,261.0,20062,,0
2021-02-22 15:00:00,Unknown,458,35832,405.0,20467,,0
2021-02-23 15:00:00,Unknown,686,36518,348.0,20815,,0
2021-02-24 15:00:00,Unknown,618,37136,494.0,21309,,0
2021-02-25 15:00:00,Unknown,637,37773,812.0,22121,,0
2021-02-26 15:00:00,Unknown,745,38518,659.0,22780,,0
2021-02-27 15:00:00,Unknown,569,39087,283.0,23063,,0
2021-02-28 15:00:00,Unknown,650,39737,168.0,23231,,0
2021-03-01 15:00:00,Unknown,829,40566,470.0,23701,,0
2021-03-02 15:00:00,Unknown,770,41336,515.0,24216,,0
2021-03-03 15:00:00,Unknown,966,42302,585.0,24801,3.0,3
2021-03-04 15:00:00,Unknown,953,43255,669.0,25470,105.0,108
2021-03-05 15:00:00,Unknown,985,44240,551.0,26021,88.0,196
2021-03-06 15:00:00,Unknown,661,44901,303.0,26324,187.0,383
2021-03-07 15:00:00,Unknown,615,45516,316.0,26640,299.0,682
2021-03-08 15:00:00,Unknown,910,46426,342.0,26982,369.0,1051
2021-03-09 15:00:00,Unknown,869,47295,454.0,27436,381.0,1432
2021-03-10 15:00:00,Unknown,766,48061,497.0,27933,505.0,1937
2021-03-11 15:00:00,Unknown,961,49022,511.0,28444,161.0,2098
2021-03-12 15:00:00,Unknown,1151,50173,549.0,28993,108.0,2206
2021-03-13 15:00:00,Unknown,809,50982,336.0,29329,51.0,2257
2021-03-14 15:00:00,Unknown,972,51954,328.0,29657,61.0,2318
2021-03-15 15:00:00,Unknown,1630,53584,397.0,30054,33.0,2351
2021-03-16 15:00:00,Unknown,1612,55196,584.0,30638,46.0,2397
2021-03-17 15:00:00,Unknown,1611,56807,682.0,31320,63.0,2460
2021-03-18 15:00:00,Unknown,1789,58596,454.0,31774,55.0,2515
2021-03-19 15:00:00,Unknown,1458,60054,423.0,32197,50.0,2565
2021-03-20 15:00:00,Unknown,1287,61341,443.0,32640,36.0,2601
2021-03-21 15:00:00,Unknown,1114,62455,337.0,32977,22.0,2623
2021-03-22 15:00:00,Unknown,1591,64046,494.0,33471,33.0,2656
2021-03-23 15:00:00,Unknown,2005,66051,613.0,34084,75.0,2731
2021-03-24 15:00:00,Unknown,2639,68690,520.0,34604,79.0,2810
2021-03-25 15:00:00,Unknown,2636,71326,588.0,35192,335.0,3145
2021-03-26 15:00:00,Unknown,2605,73931,668.0,35860,363.0,3508
2021-03-27 15:00:00,Unknown,1894,75825,512.0,36372,409.0,3917
2021-03-28 15:00:00,Unknown,1944,77769,506.0,36878,436.0,4353
2021-03-29 15:00:00,Unknown,2702,80471,944.0,37822,75.0,4428
2021-03-30 15:00:00,Unknown,2571,83042,962.0,38784,120.0,4548
2021-03-31 15:00:00,Unknown,2557,85599,847.0,39631,812.0,5360
2021-04-01 15:00:00,Unknown,1846,87445,979.0,40610,629.0,5989
2021-01-19 15:00:00,Hispanic or Latino,454,10689,146.0,1180,,0
2021-01-20 15:00:00,Hispanic or Latino,617,11306,172.0,1352,,0
2021-01-21 15:00:00,Hispanic or Latino,751,12057,112.0,1464,,0
2021-01-22 15:00:00,Hispanic or Latino,953,13010,103.0,1567,,0
2021-01-23 15:00:00,Hispanic or Latino,328,13338,48.0,1615,,0
2021-01-24 15:00:00,Hispanic or Latino,98,13436,37.0,1652,,0
2021-01-25 15:00:00,Hispanic or Latino,371,13807,302.0,1954,,0
2021-01-26 15:00:00,Hispanic or Latino,499,14306,225.0,2179,,0
2021-01-27 15:00:00,Hispanic or Latino,744,15050,429.0,2608,,0
2021-01-28 15:00:00,Hispanic or Latino,788,15838,385.0,2993,,0
2021-01-29 15:00:00,Hispanic or Latino,686,16524,288.0,3281,,0
2021-01-30 15:00:00,Hispanic or Latino,480,17004,89.0,3370,,0
2021-01-31 15:00:00,Hispanic or Latino,132,17136,26.0,3396,,0
2021-02-01 15:00:00,Hispanic or Latino,158,17294,146.0,3542,,0
2021-02-02 15:00:00,Hispanic or Latino,413,17707,589.0,4131,,0
2021-02-03 15:00:00,Hispanic or Latino,607,18314,673.0,4804,,0
2021-02-04 15:00:00,Hispanic or Latino,720,19034,710.0,5514,,0
2021-02-05 15:00:00,Hispanic or Latino,753,19787,866.0,6380,,0
2021-02-06 15:00:00,Hispanic or Latino,383,20170,203.0,6583,,0
2021-02-07 15:00:00,Hispanic or Latino,168,20338,57.0,6640,,0
2021-02-08 15:00:00,Hispanic or Latino,523,20861,586.0,7226,,0
2021-02-09 15:00:00,Hispanic or Latino,546,21407,510.0,7736,,0
2021-02-10 15:00:00,Hispanic or Latino,689,22096,679.0,8415,,0
2021-02-11 15:00:00,Hispanic or Latino,860,22956,720.0,9135,,0
2021-02-12 15:00:00,Hispanic or Latino,761,23717,843.0,9978,,0
2021-02-13 15:00:00,Hispanic or Latino,361,24078,223.0,10201,,0
2021-02-14 15:00:00,Hispanic or Latino,274,24352,63.0,10264,,0
2021-02-15 15:00:00,Hispanic or Latino,320,24672,355.0,10619,,0
2021-02-16 15:00:00,Hispanic or Latino,503,25175,540.0,11159,,0
2021-02-17 15:00:00,Hispanic or Latino,689,25864,733.0,11892,,0
2021-02-18 15:00:00,Hispanic or Latino,120,25984,122.0,12014,,0
2021-02-19 15:00:00,Hispanic or Latino,380,26364,746.0,12760,,0
2021-02-20 15:00:00,Hispanic or Latino,366,26730,622.0,13382,,0
2021-02-21 15:00:00,Hispanic or Latino,308,27038,238.0,13620,,0
2021-02-22 15:00:00,Hispanic or Latino,292,27330,406.0,14026,,0
2021-02-23 15:00:00,Hispanic or Latino,520,27850,479.0,14505,,0
2021-02-24 15:00:00,Hispanic or Latino,559,28409,797.0,15302,,0
2021-02-25 15:00:00,Hispanic or Latino,766,29175,808.0,16110,,0
2021-02-26 15:00:00,Hispanic or Latino,1106,30281,833.0,16943,,0
2021-02-27 15:00:00,Hispanic or Latino,660,30941,336.0,17279,,0
2021-02-28 15:00:00,Hispanic or Latino,713,31654,176.0,17455,,0
2021-03-01 15:00:00,Hispanic or Latino,1101,32755,407.0,17862,,0
2021-03-02 15:00:00,Hispanic or Latino,1042,33797,337.0,18199,,0
2021-03-03 15:00:00,Hispanic or Latino,1132,34929,642.0,18841,12.0,12
2021-03-04 15:00:00,Hispanic or Latino,1337,36266,479.0,19320,151.0,163
2021-03-05 15:00:00,Hispanic or Latino,1628,37894,597.0,19917,200.0,363
2021-03-06 15:00:00,Hispanic or Latino,891,38785,276.0,20193,384.0,747
2021-03-07 15:00:00,Hispanic or Latino,570,39355,195.0,20388,287.0,1034
2021-03-08 15:00:00,Hispanic or Latino,1192,40547,293.0,20681,361.0,1395
2021-03-09 15:00:00,Hispanic or Latino,1214,41761,479.0,21160,435.0,1830
2021-03-10 15:00:00,Hispanic or Latino,1354,43115,611.0,21771,520.0,2350
2021-03-11 15:00:00,Hispanic or Latino,1504,44619,658.0,22429,238.0,2588
2021-03-12 15:00:00,Hispanic or Latino,1997,46616,621.0,23050,196.0,2784
2021-03-13 15:00:00,Hispanic or Latino,1135,47751,356.0,23406,205.0,2989
2021-03-14 15:00:00,Hispanic or Latino,1402,49153,184.0,23590,107.0,3096
2021-03-15 15:00:00,Hispanic or Latino,1723,50876,327.0,23917,42.0,3138
2021-03-16 15:00:00,Hispanic or Latino,2024,52900,411.0,24328,21.0,3159
2021-03-17 15:00:00,Hispanic or Latino,2462,55362,568.0,24896,58.0,3217
2021-03-18 15:00:00,Hispanic or Latino,2594,57956,384.0,25280,99.0,3316
2021-03-19 15:00:00,Hispanic or Latino,2598,60554,523.0,25803,82.0,3398
2021-03-20 15:00:00,Hispanic or Latino,2113,62667,410.0,26213,45.0,3443
2021-03-21 15:00:00,Hispanic or Latino,1615,64282,437.0,26650,13.0,3456
2021-03-22 15:00:00,Hispanic or Latino,2196,66478,425.0,27075,31.0,3487
2021-04-02 15:00:00,Unknown,1917,89362,1260.0,41870,763.0,6752
2021-04-03 15:00:00,Unknown,1685,91047,827.0,42697,683.0,7435
2021-04-04 15:00:00,Unknown,677,91724,671.0,43368,46.0,7481
2021-04-05 15:00:00,Unknown,1892,93616,1105.0,44473,675.0,8156
2021-04-06 15:00:00,Unknown,2249,95865,1251.0,45724,896.0,9052
2021-04-07 15:00:00,Unknown,2483,98348,1326.0,47050,1360.0,10412
2021-04-08 15:00:00,Unknown,3106,101454,1504.0,48554,1523.0,11935
2021-04-09 15:00:00,Unknown,3350,104804,1079.0,49633,1295.0,13230
2021-04-10 15:00:00,Unknown,2828,107632,1050.0,50683,1009.0,14239
2021-04-11 15:00:00,Unknown,2559,110191,1061.0,51744,872.0,15111
2021-04-12 15:00:00,Unknown,2881,113072,1876.0,53620,1099.0,16210
2021-04-13 15:00:00,Unknown,3405,116477,1901.0,55521,31.0,16241
2021-04-14 15:00:00,Unknown,3240,119717,2187.0,57708,10.0,16251
2021-04-15 15:00:00,Unknown,3895,123612,2330.0,60038,15.0,16266
2021-04-16 15:00:00,Unknown,3542,127154,2397.0,62435,1.0,16267
2021-04-17 15:00:00,Unknown,3821,130975,1673.0,64108,1.0,16268
2021-04-18 15:00:00,Unknown,3108,134083,1717.0,65825,,16268
2021-04-19 15:00:00,Unknown,2967,137050,2438.0,68263,3.0,16271
2021-04-20 15:00:00,Unknown,2458,139508,2186.0,70449,,16271
2021-04-21 15:00:00,Unknown,3204,142712,2517.0,72966,,16271
2021-04-22 15:00:00,Unknown,3000,145712,1289.0,74255,,16271
2021-04-23 15:00:00,Unknown,3542,149254,1985.0,76240,2.0,16273
2021-04-24 15:00:00,Unknown,3436,152690,1558.0,77798,3.0,16276
2021-04-25 15:00:00,Unknown,2621,155311,776.0,78574,,16276
2021-04-26 15:00:00,Unknown,1970,157281,1449.0,80023,11.0,16287
2021-04-27 15:00:00,Unknown,2518,159799,1349.0,81372,66.0,16353
2021-04-28 15:00:00,Unknown,2308,162107,2566.0,83938,90.0,16443
2021-04-29 15:00:00,Unknown,2105,164212,2704.0,86642,78.0,16521
2021-04-30 15:00:00,Unknown,2221,166433,2793.0,89435,114.0,16635
2021-05-01 15:00:00,Unknown,1703,168136,2617.0,92052,57.0,16692
2021-05-02 15:00:00,Unknown,1347,169483,2275.0,94327,38.0,16730
2021-05-03 15:00:00,Unknown,919,170402,2785.0,97112,91.0,16821
2021-05-04 15:00:00,Unknown,887,171289,3053.0,100165,104.0,16925
2021-05-05 15:00:00,Unknown,1546,172835,2969.0,103134,117.0,17042
2021-05-06 15:00:00,Unknown,1365,174200,3323.0,106457,89.0,17131
2021-05-07 15:00:00,Unknown,1448,175648,2838.0,109295,105.0,17236
2021-05-08 15:00:00,Unknown,1112,176760,3179.0,112474,109.0,17345
2021-05-09 15:00:00,Unknown,734,177494,1543.0,114017,37.0,17382
2021-05-10 15:00:00,Unknown,723,178217,2911.0,116928,72.0,17454
2021-05-11 15:00:00,Unknown,832,179049,2314.0,119242,74.0,17528
2021-05-12 15:00:00,Unknown,982,180031,2662.0,121904,151.0,17679
2021-05-13 15:00:00,Unknown,1173,181204,2269.0,124173,139.0,17818
2021-05-14 15:00:00,Unknown,1381,182585,2134.0,126307,195.0,18013
2020-12-14 15:00:00,Not Hispanic or Latino,2,2,,0,,0
2020-12-15 15:00:00,Not Hispanic or Latino,12,14,1.0,1,,0
2020-12-16 15:00:00,Not Hispanic or Latino,517,531,2.0,3,,0
2020-12-17 15:00:00,Not Hispanic or Latino,1006,1537,,3,,0
2020-12-18 15:00:00,Not Hispanic or Latino,2695,4232,2.0,5,,0
2020-12-19 15:00:00,Not Hispanic or Latino,793,5025,1.0,6,,0
2020-12-20 15:00:00,Not Hispanic or Latino,244,5269,2.0,8,,0
2020-12-21 15:00:00,Not Hispanic or Latino,3508,8777,,8,,0
2020-12-22 15:00:00,Not Hispanic or Latino,5502,14279,1.0,9,,0
2020-12-23 15:00:00,Not Hispanic or Latino,5102,19381,6.0,15,,0
2020-12-24 15:00:00,Not Hispanic or Latino,2494,21875,3.0,18,,0
2021-03-23 15:00:00,Hispanic or Latino,2597,69075,606.0,27681,134.0,3621
2021-03-24 15:00:00,Hispanic or Latino,3175,72250,816.0,28497,201.0,3822
2021-03-25 15:00:00,Hispanic or Latino,3328,75578,815.0,29312,113.0,3935
2021-03-26 15:00:00,Hispanic or Latino,2482,78060,1229.0,30541,200.0,4135
2021-03-27 15:00:00,Hispanic or Latino,2216,80276,803.0,31344,137.0,4272
2021-03-28 15:00:00,Hispanic or Latino,1111,81387,530.0,31874,71.0,4343
2021-03-29 15:00:00,Hispanic or Latino,1992,83379,1203.0,33077,58.0,4401
2021-03-30 15:00:00,Hispanic or Latino,2714,86093,1160.0,34237,108.0,4509
2021-03-31 15:00:00,Hispanic or Latino,3377,89470,1318.0,35555,383.0,4892
2021-04-01 15:00:00,Hispanic or Latino,2857,92327,1632.0,37187,288.0,5180
2021-04-02 15:00:00,Hispanic or Latino,2778,95105,1814.0,39001,327.0,5507
2021-04-03 15:00:00,Hispanic or Latino,2159,97264,927.0,39928,272.0,5779
2021-04-04 15:00:00,Hispanic or Latino,762,98026,491.0,40419,47.0,5826
2021-04-05 15:00:00,Hispanic or Latino,2316,100342,1455.0,41874,358.0,6184
2021-04-06 15:00:00,Hispanic or Latino,3101,103443,1759.0,43633,508.0,6692
2021-04-07 15:00:00,Hispanic or Latino,3530,106973,1712.0,45345,845.0,7537
2021-04-08 15:00:00,Hispanic or Latino,3315,110288,1882.0,47227,1199.0,8736
2021-04-09 15:00:00,Hispanic or Latino,3213,113501,2169.0,49396,1089.0,9825
2021-04-10 15:00:00,Hispanic or Latino,2207,115708,1541.0,50937,601.0,10426
2021-04-11 15:00:00,Hispanic or Latino,2157,117865,1288.0,52225,640.0,11066
2021-04-12 15:00:00,Hispanic or Latino,2150,120015,2064.0,54289,774.0,11840
2021-04-13 15:00:00,Hispanic or Latino,3620,123635,2479.0,56768,30.0,11870
2021-04-14 15:00:00,Hispanic or Latino,4403,128038,2563.0,59331,35.0,11905
2021-04-15 15:00:00,Hispanic or Latino,3647,131685,2227.0,61558,25.0,11930
2021-04-16 15:00:00,Hispanic or Latino,3703,135388,2783.0,64341,,11930
2021-04-17 15:00:00,Hispanic or Latino,3654,139042,1820.0,66161,,11930
2021-04-18 15:00:00,Hispanic or Latino,2311,141353,1180.0,67341,,11930
2021-04-19 15:00:00,Hispanic or Latino,3337,144690,1873.0,69214,4.0,11934
2021-04-20 15:00:00,Hispanic or Latino,3528,148218,2395.0,71609,,11934
2021-04-21 15:00:00,Hispanic or Latino,4902,153120,3051.0,74660,,11934
2021-04-22 15:00:00,Hispanic or Latino,3892,157012,3114.0,77774,,11934
2021-04-23 15:00:00,Hispanic or Latino,3606,160618,2988.0,80762,,11934
2021-04-24 15:00:00,Hispanic or Latino,4252,164870,2542.0,83304,7.0,11941
2021-04-25 15:00:00,Hispanic or Latino,2803,167673,807.0,84111,3.0,11944
2021-04-26 15:00:00,Hispanic or Latino,3225,170898,2207.0,86318,15.0,11959
2021-04-27 15:00:00,Hispanic or Latino,3073,173971,2320.0,88638,83.0,12042
2021-04-28 15:00:00,Hispanic or Latino,3463,177434,3520.0,92158,138.0,12180
2021-04-29 15:00:00,Hispanic or Latino,3438,180872,3000.0,95158,149.0,12329
2021-04-30 15:00:00,Hispanic or Latino,4020,184892,2670.0,97828,167.0,12496
2021-05-01 15:00:00,Hispanic or Latino,3299,188191,2174.0,100002,122.0,12618
2021-05-02 15:00:00,Hispanic or Latino,1571,189762,1569.0,101571,126.0,12744
2021-05-03 15:00:00,Hispanic or Latino,1864,191626,2116.0,103687,234.0,12978
2021-05-04 15:00:00,Hispanic or Latino,1764,193390,3060.0,106747,176.0,13154
2021-05-05 15:00:00,Hispanic or Latino,2763,196153,3693.0,110440,217.0,13371
2021-05-06 15:00:00,Hispanic or Latino,2118,198271,3360.0,113800,164.0,13535
2021-05-07 15:00:00,Hispanic or Latino,2906,201177,3258.0,117058,191.0,13726
2021-05-08 15:00:00,Hispanic or Latino,1938,203115,2865.0,119923,173.0,13899
2021-05-09 15:00:00,Hispanic or Latino,931,204046,1413.0,121336,100.0,13999
2021-05-10 15:00:00,Hispanic or Latino,1267,205313,3023.0,124359,134.0,14133
2021-05-11 15:00:00,Hispanic or Latino,1635,206948,2898.0,127257,146.0,14279
2021-05-12 15:00:00,Hispanic or Latino,2043,208991,3956.0,131213,309.0,14588
2021-05-13 15:00:00,Hispanic or Latino,1885,210876,2800.0,134013,93.0,14681
2021-05-14 15:00:00,Hispanic or Latino,1524,212400,1696.0,135709,96.0,14777
2020-12-25 15:00:00,Not Hispanic or Latino,804,22679,1.0,19,,0
2020-12-26 15:00:00,Not Hispanic or Latino,1413,24092,3.0,22,,0
2020-12-27 15:00:00,Not Hispanic or Latino,1568,25660,4.0,26,,0
2020-12-28 15:00:00,Not Hispanic or Latino,8074,33734,8.0,34,,0
2020-12-29 15:00:00,Not Hispanic or Latino,9493,43227,5.0,39,,0
2020-12-30 15:00:00,Not Hispanic or Latino,11322,54549,13.0,52,,0
2020-12-31 15:00:00,Not Hispanic or Latino,6799,61348,8.0,60,,0
2021-01-01 15:00:00,Not Hispanic or Latino,1426,62774,22.0,82,,0
2021-01-02 15:00:00,Not Hispanic or Latino,2335,65109,19.0,101,,0
2021-01-03 15:00:00,Not Hispanic or Latino,2789,67898,62.0,163,,0
2021-01-04 15:00:00,Not Hispanic or Latino,11551,79449,235.0,398,,0
2021-01-05 15:00:00,Not Hispanic or Latino,10785,90234,406.0,804,,0
2021-01-06 15:00:00,Not Hispanic or Latino,13433,103667,730.0,1534,,0
2021-01-07 15:00:00,Not Hispanic or Latino,13416,117083,1485.0,3019,,0
2021-01-08 15:00:00,Not Hispanic or Latino,14424,131507,2399.0,5418,,0
2021-01-09 15:00:00,Not Hispanic or Latino,4436,135943,800.0,6218,,0
2021-01-10 15:00:00,Not Hispanic or Latino,2430,138373,309.0,6527,,0
2021-01-11 15:00:00,Not Hispanic or Latino,12438,150811,3056.0,9583,,0
2021-01-12 15:00:00,Not Hispanic or Latino,15249,166060,4761.0,14344,,0
2021-01-13 15:00:00,Not Hispanic or Latino,16788,182848,3379.0,17723,,0
2021-01-14 15:00:00,Not Hispanic or Latino,16255,199103,1705.0,19428,,0
2021-01-15 15:00:00,Not Hispanic or Latino,17557,216660,1558.0,20986,,0
2021-01-16 15:00:00,Not Hispanic or Latino,5183,221843,1115.0,22101,,0
2021-01-17 15:00:00,Not Hispanic or Latino,1885,223728,1178.0,23279,,0
2021-01-18 15:00:00,Not Hispanic or Latino,6777,230505,2552.0,25831,,0
2021-01-19 15:00:00,Not Hispanic or Latino,15685,246190,4246.0,30077,,0
2021-01-20 15:00:00,Not Hispanic or Latino,19577,265767,4477.0,34554,,0
2021-01-21 15:00:00,Not Hispanic or Latino,21802,287569,3077.0,37631,,0
2021-01-22 15:00:00,Not Hispanic or Latino,26625,314194,2918.0,40549,,0
2021-01-23 15:00:00,Not Hispanic or Latino,8717,322911,1287.0,41836,,0
2021-01-24 15:00:00,Not Hispanic or Latino,2964,325875,1360.0,43196,,0
2021-01-25 15:00:00,Not Hispanic or Latino,15269,341144,7317.0,50513,,0
2021-01-26 15:00:00,Not Hispanic or Latino,16118,357262,7745.0,58258,,0
2021-01-27 15:00:00,Not Hispanic or Latino,22805,380067,11031.0,69289,,0
2021-01-28 15:00:00,Not Hispanic or Latino,20952,401019,8252.0,77541,,0
2021-01-29 15:00:00,Not Hispanic or Latino,22527,423546,6454.0,83995,,0
2021-01-30 15:00:00,Not Hispanic or Latino,16597,440143,2151.0,86146,,0
2021-01-31 15:00:00,Not Hispanic or Latino,3166,443309,1096.0,87242,,0
2021-02-01 15:00:00,Not Hispanic or Latino,5901,449210,3812.0,91054,,0
2021-02-02 15:00:00,Not Hispanic or Latino,10822,460032,11988.0,103042,,0
2021-02-03 15:00:00,Not Hispanic or Latino,16224,476256,16526.0,119568,,0
2021-02-04 15:00:00,Not Hispanic or Latino,19981,496237,14081.0,133649,,0
2021-02-05 15:00:00,Not Hispanic or Latino,18364,514601,15603.0,149252,,0
2021-02-06 15:00:00,Not Hispanic or Latino,10275,524876,5655.0,154907,,0
2021-02-07 15:00:00,Not Hispanic or Latino,5278,530154,1441.0,156348,,0
2021-02-08 15:00:00,Not Hispanic or Latino,11366,541520,11565.0,167913,,0
2021-02-09 15:00:00,Not Hispanic or Latino,14837,556357,12435.0,180348,,0
2021-02-10 15:00:00,Not Hispanic or Latino,17431,573788,19565.0,199913,,0
2021-02-11 15:00:00,Not Hispanic or Latino,20967,594755,15677.0,215590,,0
2021-02-12 15:00:00,Not Hispanic or Latino,18332,613087,17653.0,233243,,0
2021-02-13 15:00:00,Not Hispanic or Latino,10212,623299,5579.0,238822,,0
2021-02-14 15:00:00,Not Hispanic or Latino,6245,629544,1743.0,240565,,0
2021-02-15 15:00:00,Not Hispanic or Latino,10932,640476,11227.0,251792,,0
2021-02-16 15:00:00,Not Hispanic or Latino,15233,655709,19254.0,271046,,0
2021-02-17 15:00:00,Not Hispanic or Latino,19017,674726,24477.0,295523,,0
2021-02-18 15:00:00,Not Hispanic or Latino,2888,677614,3790.0,299313,,0
2021-02-19 15:00:00,Not Hispanic or Latino,9736,687350,17727.0,317040,,0
2021-02-20 15:00:00,Not Hispanic or Latino,9218,696568,18739.0,335779,,0
2021-02-21 15:00:00,Not Hispanic or Latino,5411,701979,6741.0,342520,,0
2021-02-22 15:00:00,Not Hispanic or Latino,7305,709284,14079.0,356599,,0
2021-02-23 15:00:00,Not Hispanic or Latino,14260,723544,14461.0,371060,,0
2021-02-24 15:00:00,Not Hispanic or Latino,16595,740139,22917.0,393977,,0
2021-02-25 15:00:00,Not Hispanic or Latino,18714,758853,24288.0,418265,,0
2021-02-26 15:00:00,Not Hispanic or Latino,24505,783358,23845.0,442110,,0
2021-02-27 15:00:00,Not Hispanic or Latino,14577,797935,10108.0,452218,,0
2021-02-28 15:00:00,Not Hispanic or Latino,14052,811987,4097.0,456315,,0
2021-03-01 15:00:00,Not Hispanic or Latino,22263,834250,10449.0,466764,,0
2021-03-02 15:00:00,Not Hispanic or Latino,21518,855768,11969.0,478733,13.0,13
2021-03-03 15:00:00,Not Hispanic or Latino,27221,882989,16577.0,495310,127.0,140
2021-03-04 15:00:00,Not Hispanic or Latino,28106,911095,16445.0,511755,3803.0,3943
2021-03-05 15:00:00,Not Hispanic or Latino,25824,936919,17443.0,529198,4555.0,8498
2021-03-06 15:00:00,Not Hispanic or Latino,15970,952889,8024.0,537222,5378.0,13876
2021-03-07 15:00:00,Not Hispanic or Latino,10756,963645,3972.0,541194,5974.0,19850
2021-03-08 15:00:00,Not Hispanic or Latino,23227,986872,7738.0,548932,7452.0,27302
2021-03-09 15:00:00,Not Hispanic or Latino,23489,1010361,13999.0,562931,7435.0,34737
2021-03-10 15:00:00,Not Hispanic or Latino,26931,1037292,14358.0,577289,6875.0,41612
2021-03-11 15:00:00,Not Hispanic or Latino,31036,1068328,14697.0,591986,3299.0,44911
2021-03-12 15:00:00,Not Hispanic or Latino,32664,1100992,15089.0,607075,2208.0,47119
2021-03-13 15:00:00,Not Hispanic or Latino,19502,1120494,8270.0,615345,1129.0,48248
2021-03-14 15:00:00,Not Hispanic or Latino,14028,1134522,5069.0,620414,751.0,48999
2021-03-15 15:00:00,Not Hispanic or Latino,25490,1160012,9755.0,630169,466.0,49465
2021-03-16 15:00:00,Not Hispanic or Latino,29261,1189273,12051.0,642220,692.0,50157
2021-03-17 15:00:00,Not Hispanic or Latino,32928,1222201,15180.0,657400,1016.0,51173
2021-03-18 15:00:00,Not Hispanic or Latino,36427,1258628,11126.0,668526,1137.0,52310
2021-03-19 15:00:00,Not Hispanic or Latino,33396,1292024,13920.0,682446,872.0,53182
2021-03-20 15:00:00,Not Hispanic or Latino,20713,1312737,8853.0,691299,581.0,53763
2021-03-21 15:00:00,Not Hispanic or Latino,16066,1328803,6564.0,697863,270.0,54033
2021-03-22 15:00:00,Not Hispanic or Latino,28309,1357112,9997.0,707860,752.0,54785
2021-03-23 15:00:00,Not Hispanic or Latino,32492,1389604,15460.0,723320,1292.0,56077
2021-03-24 15:00:00,Not Hispanic or Latino,34715,1424319,19020.0,742340,1067.0,57144
2021-03-25 15:00:00,Not Hispanic or Latino,35891,1460210,18760.0,761100,2002.0,59146
2021-03-26 15:00:00,Not Hispanic or Latino,31285,1491495,23212.0,784312,1927.0,61073
2021-03-27 15:00:00,Not Hispanic or Latino,22707,1514202,15060.0,799372,1837.0,62910
2021-03-28 15:00:00,Not Hispanic or Latino,13878,1528080,11252.0,810624,1103.0,64013
2021-03-29 15:00:00,Not Hispanic or Latino,24880,1552960,23384.0,834008,980.0,64993
2021-03-30 15:00:00,Not Hispanic or Latino,34188,1587148,25938.0,859946,1583.0,66576
2021-03-31 15:00:00,Not Hispanic or Latino,34681,1621829,31449.0,891395,4493.0,71069
2021-04-01 15:00:00,Not Hispanic or Latino,35817,1657646,33604.0,924999,4495.0,75564
2021-04-02 15:00:00,Not Hispanic or Latino,30168,1687814,27914.0,952913,4661.0,80225
2021-04-03 15:00:00,Not Hispanic or Latino,18003,1705817,15949.0,968862,3366.0,83591
2021-04-04 15:00:00,Not Hispanic or Latino,7527,1713344,8061.0,976923,814.0,84405
2021-04-05 15:00:00,Not Hispanic or Latino,23725,1737069,25099.0,1002022,5536.0,89941
2021-04-06 15:00:00,Not Hispanic or Latino,34224,1771293,26467.0,1028489,9026.0,98967
2021-04-07 15:00:00,Not Hispanic or Latino,29581,1800874,30133.0,1058622,10431.0,109398
2021-04-08 15:00:00,Not Hispanic or Latino,35421,1836295,31902.0,1090524,10918.0,120316
2021-04-09 15:00:00,Not Hispanic or Latino,27025,1863320,32197.0,1122721,12001.0,132317
2021-04-10 15:00:00,Not Hispanic or Latino,18462,1881782,19780.0,1142501,5916.0,138233
2021-04-11 15:00:00,Not Hispanic or Latino,13071,1894853,10363.0,1152864,8546.0,146779
2021-04-12 15:00:00,Not Hispanic or Latino,19412,1914265,28279.0,1181143,8947.0,155726
2021-04-13 15:00:00,Not Hispanic or Latino,35294,1949559,31237.0,1212380,274.0,156000
2021-04-14 15:00:00,Not Hispanic or Latino,32326,1981885,32207.0,1244587,156.0,156156
2021-04-15 15:00:00,Not Hispanic or Latino,32991,2014876,32840.0,1277427,108.0,156264
2021-04-16 15:00:00,Not Hispanic or Latino,28840,2043716,31744.0,1309171,9.0,156273
2021-04-17 15:00:00,Not Hispanic or Latino,24035,2067751,16863.0,1326034,4.0,156277
2021-04-18 15:00:00,Not Hispanic or Latino,14125,2081876,12879.0,1338913,3.0,156280
2021-04-19 15:00:00,Not Hispanic or Latino,21827,2103703,29277.0,1368190,45.0,156325
2021-04-20 15:00:00,Not Hispanic or Latino,22652,2126355,35447.0,1403637,32.0,156357
2021-04-21 15:00:00,Not Hispanic or Latino,28179,2154534,36034.0,1439671,14.0,156371
2021-04-22 15:00:00,Not Hispanic or Latino,27673,2182207,34141.0,1473812,15.0,156386
2021-04-23 15:00:00,Not Hispanic or Latino,23540,2205747,32596.0,1506408,10.0,156396
2021-04-24 15:00:00,Not Hispanic or Latino,18489,2224236,23285.0,1529693,61.0,156457
2021-04-25 15:00:00,Not Hispanic or Latino,13714,2237950,6588.0,1536281,21.0,156478
2021-04-26 15:00:00,Not Hispanic or Latino,18232,2256182,24988.0,1561269,177.0,156655
2021-04-27 15:00:00,Not Hispanic or Latino,18459,2274641,26326.0,1587595,739.0,157394
2021-04-28 15:00:00,Not Hispanic or Latino,21571,2296212,30999.0,1618594,1064.0,158458
2021-04-29 15:00:00,Not Hispanic or Latino,20286,2316498,30697.0,1649291,1186.0,159644
2021-04-30 15:00:00,Not Hispanic or Latino,20675,2337173,25008.0,1674299,1308.0,160952
2021-05-01 15:00:00,Not Hispanic or Latino,12574,2349747,17445.0,1691744,730.0,161682
2021-05-02 15:00:00,Not Hispanic or Latino,6186,2355933,10970.0,1702714,623.0,162305
2021-05-03 15:00:00,Not Hispanic or Latino,9777,2365710,21028.0,1723742,1541.0,163846
2021-05-04 15:00:00,Not Hispanic or Latino,10624,2376334,30945.0,1754687,1432.0,165278
2021-05-05 15:00:00,Not Hispanic or Latino,13564,2389898,28190.0,1782877,1553.0,166831
2021-05-06 15:00:00,Not Hispanic or Latino,12969,2402867,30673.0,1813550,1415.0,168246
2021-05-07 15:00:00,Not Hispanic or Latino,12277,2415144,26704.0,1840254,1601.0,169847
2021-05-08 15:00:00,Not Hispanic or Latino,6996,2422140,21974.0,1862228,989.0,170836
2021-05-09 15:00:00,Not Hispanic or Latino,3443,2425583,8082.0,1870310,552.0,171388
2021-05-10 15:00:00,Not Hispanic or Latino,6346,2431929,22231.0,1892541,1029.0,172417
2021-05-11 15:00:00,Not Hispanic or Latino,8593,2440522,22434.0,1914975,1077.0,173494
2021-05-12 15:00:00,Not Hispanic or Latino,9393,2449915,27054.0,1942029,1194.0,174688
2021-05-13 15:00:00,Not Hispanic or Latino,13368,2463283,21904.0,1963933,797.0,175485
2021-05-14 15:00:00,Not Hispanic or Latino,9423,2472706,11908.0,1975841,737.0,176222
