VACCINATION_DATE,Ethnicity,FirstDoseDaily,FirstDoseCumulative,SecondDoseDaily,SecondDoseCumulative,SingleDoseDaily,SingleDoseCumulative
2020-12-14 15:00:00,Unknown,1,1,,0,,0
2020-12-16 15:00:00,Unknown,10,11,,0,,0
2020-12-17 15:00:00,Unknown,16,27,,0,,0
2020-12-18 15:00:00,Unknown,89,116,,0,,0
2020-12-19 15:00:00,Unknown,27,143,,0,,0
2020-12-20 15:00:00,Unknown,32,175,,0,,0
2020-12-21 15:00:00,Unknown,70,245,,0,,0
2020-12-22 15:00:00,Unknown,419,664,,0,,0
2020-12-23 15:00:00,Unknown,191,855,,0,,0
2020-12-24 15:00:00,Unknown,61,916,,0,,0
2020-12-25 15:00:00,Unknown,184,1100,,0,,0
2020-12-26 15:00:00,Unknown,203,1303,,0,,0
2020-12-27 15:00:00,Unknown,142,1445,,0,,0
2020-12-28 15:00:00,Unknown,279,1724,,0,,0
2020-12-29 15:00:00,Unknown,446,2170,,0,,0
2020-12-30 15:00:00,Unknown,359,2529,,0,,0
2020-12-31 15:00:00,Unknown,201,2730,2.0,2,,0
2021-01-01 15:00:00,Unknown,150,2880,1.0,3,,0
2021-01-02 15:00:00,Unknown,170,3050,2.0,5,,0
2021-01-03 15:00:00,Unknown,235,3285,4.0,9,,0
2021-01-04 15:00:00,Unknown,590,3875,6.0,15,,0
2021-01-05 15:00:00,Unknown,484,4359,17.0,32,,0
2021-01-06 15:00:00,Unknown,659,5018,22.0,54,,0
2021-01-07 15:00:00,Unknown,419,5437,56.0,110,,0
2021-01-08 15:00:00,Unknown,8301,13738,74.0,184,,0
2021-01-09 15:00:00,Unknown,206,13944,40.0,224,,0
2021-01-10 15:00:00,Unknown,176,14120,10.0,234,,0
2021-01-11 15:00:00,Unknown,316,14436,77.0,311,,0
2021-01-12 15:00:00,Unknown,708,15144,348.0,659,,0
2021-01-13 15:00:00,Unknown,381,15525,134.0,793,,0
2021-01-14 15:00:00,Unknown,391,15916,59.0,852,,0
2021-01-15 15:00:00,Unknown,542,16458,182.0,1034,,0
2021-01-16 15:00:00,Unknown,307,16765,165.0,1199,,0
2021-01-17 15:00:00,Unknown,110,16875,98.0,1297,,0
2021-01-18 15:00:00,Unknown,180,17055,201.0,1498,,0
2021-01-19 15:00:00,Unknown,300,17355,237.0,1735,,0
2021-01-20 15:00:00,Unknown,330,17685,150.0,1885,,0
2021-01-21 15:00:00,Unknown,347,18032,72.0,1957,,0
2021-01-22 15:00:00,Unknown,710,18742,164.0,2121,,0
2021-01-23 15:00:00,Unknown,413,19155,127.0,2248,,0
2021-01-24 15:00:00,Unknown,200,19355,154.0,2402,,0
2021-01-25 15:00:00,Unknown,556,19911,472.0,2874,,0
2021-01-26 15:00:00,Unknown,644,20555,363.0,3237,,0
2021-01-27 15:00:00,Unknown,503,21058,528.0,3765,,0
2021-01-28 15:00:00,Unknown,479,21537,266.0,4031,,0
2021-01-29 15:00:00,Unknown,347,21884,170.0,4201,,0
2021-01-30 15:00:00,Unknown,305,22189,49.0,4250,,0
2021-01-31 15:00:00,Unknown,360,22549,86.0,4336,,0
2021-02-01 15:00:00,Unknown,412,22961,181.0,4517,,0
2021-02-02 15:00:00,Unknown,525,23486,631.0,5148,,0
2021-02-03 15:00:00,Unknown,672,24158,444.0,5592,,0
2021-02-04 15:00:00,Unknown,849,25007,403.0,5995,,0
2021-02-05 15:00:00,Unknown,665,25672,422.0,6417,,0
2021-02-06 15:00:00,Unknown,380,26052,8214.0,14631,,0
2021-02-07 15:00:00,Unknown,384,26436,89.0,14720,,0
2021-02-08 15:00:00,Unknown,661,27097,249.0,14969,,0
2021-02-09 15:00:00,Unknown,746,27843,289.0,15258,,0
2021-02-10 15:00:00,Unknown,827,28670,403.0,15661,,0
2021-02-11 15:00:00,Unknown,895,29565,398.0,16059,,0
2021-02-12 15:00:00,Unknown,749,30314,556.0,16615,,0
2021-02-13 15:00:00,Unknown,398,30712,157.0,16772,,0
2021-02-14 15:00:00,Unknown,450,31162,130.0,16902,,0
2021-02-15 15:00:00,Unknown,445,31607,489.0,17391,,0
2021-02-16 15:00:00,Unknown,724,32331,674.0,18065,,0
2021-02-17 15:00:00,Unknown,825,33156,453.0,18518,,0
2021-02-18 15:00:00,Unknown,285,33441,224.0,18742,,0
2021-02-19 15:00:00,Unknown,628,34069,416.0,19158,,0
2021-02-20 15:00:00,Unknown,473,34542,355.0,19513,,0
2021-02-21 15:00:00,Unknown,337,34879,263.0,19776,,0
2021-02-22 15:00:00,Unknown,450,35329,403.0,20179,,0
2021-02-23 15:00:00,Unknown,682,36011,347.0,20526,,0
2021-02-24 15:00:00,Unknown,617,36628,497.0,21023,,0
2021-02-25 15:00:00,Unknown,620,37248,823.0,21846,,0
2021-02-26 15:00:00,Unknown,745,37993,664.0,22510,,0
2021-02-27 15:00:00,Unknown,564,38557,301.0,22811,,0
2021-02-28 15:00:00,Unknown,652,39209,180.0,22991,,0
2021-03-01 15:00:00,Unknown,831,40040,470.0,23461,,0
2021-03-02 15:00:00,Unknown,769,40809,505.0,23966,,0
2021-03-03 15:00:00,Unknown,961,41770,585.0,24551,2.0,2
2021-03-04 15:00:00,Unknown,953,42723,676.0,25227,105.0,107
2021-03-05 15:00:00,Unknown,976,43699,559.0,25786,88.0,195
2021-03-06 15:00:00,Unknown,659,44358,300.0,26086,187.0,382
2021-03-07 15:00:00,Unknown,615,44973,318.0,26404,299.0,681
2021-03-08 15:00:00,Unknown,908,45881,345.0,26749,369.0,1050
2021-03-09 15:00:00,Unknown,869,46750,455.0,27204,382.0,1432
2021-03-10 15:00:00,Unknown,768,47518,497.0,27701,506.0,1938
2021-03-11 15:00:00,Unknown,965,48483,519.0,28220,180.0,2118
2021-03-12 15:00:00,Unknown,1197,49680,613.0,28833,146.0,2264
2021-03-13 15:00:00,Unknown,853,50533,373.0,29206,72.0,2336
2021-03-14 15:00:00,Unknown,1054,51587,359.0,29565,69.0,2405
2021-03-15 15:00:00,Unknown,1637,53224,412.0,29977,34.0,2439
2021-03-16 15:00:00,Unknown,1612,54836,587.0,30564,46.0,2485
2021-03-17 15:00:00,Unknown,1611,56447,681.0,31245,62.0,2547
2021-03-18 15:00:00,Unknown,1789,58236,453.0,31698,55.0,2602
2021-03-19 15:00:00,Unknown,1453,59689,426.0,32124,50.0,2652
2021-03-20 15:00:00,Unknown,1284,60973,444.0,32568,37.0,2689
2021-03-21 15:00:00,Unknown,1115,62088,336.0,32904,23.0,2712
2021-03-22 15:00:00,Unknown,1589,63677,492.0,33396,33.0,2745
2021-03-23 15:00:00,Unknown,2019,65696,611.0,34007,75.0,2820
2021-03-24 15:00:00,Unknown,2633,68329,522.0,34529,79.0,2899
2021-03-25 15:00:00,Unknown,2634,70963,586.0,35115,335.0,3234
2021-03-26 15:00:00,Unknown,2598,73561,669.0,35784,361.0,3595
2021-03-27 15:00:00,Unknown,1888,75449,511.0,36295,408.0,4003
2021-03-28 15:00:00,Unknown,1939,77388,506.0,36801,434.0,4437
2021-03-29 15:00:00,Unknown,2681,80069,945.0,37746,75.0,4512
2021-03-30 15:00:00,Unknown,2551,82620,967.0,38713,125.0,4637
2021-03-31 15:00:00,Unknown,2545,85165,852.0,39565,817.0,5454
2021-04-01 15:00:00,Unknown,1844,87009,984.0,40549,633.0,6087
2021-04-13 15:00:00,Federal Entities,84295,84295,54201.0,54201,2952.0,2952
2021-04-14 15:00:00,Federal Entities,557,84852,11.0,54212,1.0,2953
2021-04-15 15:00:00,Federal Entities,623,85475,823.0,55035,19.0,2972
2021-04-16 15:00:00,Federal Entities,782,86257,1016.0,56051,8.0,2980
2021-04-17 15:00:00,Federal Entities,1136,87393,1177.0,57228,6.0,2986
2021-04-19 15:00:00,Federal Entities,1369,88762,2003.0,59231,9.0,2995
2021-04-20 15:00:00,Federal Entities,3243,92005,2158.0,61389,19.0,3014
2021-04-21 15:00:00,Federal Entities,906,92911,1206.0,62595,4.0,3018
2021-04-22 15:00:00,Federal Entities,1018,93929,458.0,63053,,3018
2021-04-23 15:00:00,Federal Entities,759,94688,632.0,63685,1.0,3019
2021-04-25 15:00:00,Federal Entities,992,95680,2492.0,66177,5.0,3024
2021-04-26 15:00:00,Federal Entities,1483,97163,1672.0,67849,1.0,3025
2021-04-29 15:00:00,Federal Entities,223,97386,865.0,68714,2.0,3027
2021-05-01 15:00:00,Federal Entities,1556,98942,1974.0,70688,14.0,3041
2021-05-02 15:00:00,Federal Entities,1071,100013,1875.0,72563,4.0,3045
2021-05-03 15:00:00,Federal Entities,403,100416,2165.0,74728,4.0,3049
2021-05-04 15:00:00,Federal Entities,28,100444,25.0,74753,,3049
2021-05-05 15:00:00,Federal Entities,365,100809,814.0,75567,,3049
2021-05-06 15:00:00,Federal Entities,275,101084,880.0,76447,3.0,3052
2021-05-07 15:00:00,Federal Entities,274,101358,966.0,77413,8.0,3060
2021-05-08 15:00:00,Federal Entities,297,101655,1312.0,78725,6.0,3066
2021-05-10 15:00:00,Federal Entities,338,101993,1712.0,80437,1.0,3067
2021-05-11 15:00:00,Federal Entities,18,102011,13.0,80450,,3067
2021-05-12 15:00:00,Federal Entities,243,102254,1124.0,81574,,3067
2021-05-14 15:00:00,Federal Entities,290,102544,1022.0,82596,2.0,3069
2021-05-15 15:00:00,Federal Entities,611,103155,1701.0,84297,4.0,3073
2021-05-17 15:00:00,Federal Entities,565,103720,2505.0,86802,11.0,3084
2021-05-18 15:00:00,Federal Entities,164,103884,61.0,86863,2.0,3086
2020-12-15 15:00:00,Hispanic or Latino,2,2,,0,,0
2020-12-16 15:00:00,Hispanic or Latino,18,20,,0,,0
2020-12-17 15:00:00,Hispanic or Latino,32,52,,0,,0
2020-12-18 15:00:00,Hispanic or Latino,84,136,,0,,0
2020-12-19 15:00:00,Hispanic or Latino,33,169,,0,,0
2020-12-20 15:00:00,Hispanic or Latino,8,177,,0,,0
2020-12-21 15:00:00,Hispanic or Latino,149,326,1.0,1,,0
2020-12-22 15:00:00,Hispanic or Latino,251,577,,1,,0
2020-12-23 15:00:00,Hispanic or Latino,182,759,1.0,2,,0
2020-12-24 15:00:00,Hispanic or Latino,89,848,,2,,0
2020-12-25 15:00:00,Hispanic or Latino,37,885,,2,,0
2020-12-26 15:00:00,Hispanic or Latino,39,924,,2,,0
2020-12-27 15:00:00,Hispanic or Latino,57,981,,2,,0
2020-12-28 15:00:00,Hispanic or Latino,258,1239,1.0,3,,0
2020-12-29 15:00:00,Hispanic or Latino,360,1599,1.0,4,,0
2020-12-30 15:00:00,Hispanic or Latino,500,2099,2.0,6,,0
2020-12-31 15:00:00,Hispanic or Latino,311,2410,2.0,8,,0
2021-01-01 15:00:00,Hispanic or Latino,47,2457,3.0,11,,0
2021-01-02 15:00:00,Hispanic or Latino,80,2537,2.0,13,,0
2021-01-03 15:00:00,Hispanic or Latino,117,2654,3.0,16,,0
2021-01-04 15:00:00,Hispanic or Latino,606,3260,11.0,27,,0
2021-01-05 15:00:00,Hispanic or Latino,399,3659,18.0,45,,0
2021-01-06 15:00:00,Hispanic or Latino,576,4235,19.0,64,,0
2021-01-07 15:00:00,Hispanic or Latino,797,5032,55.0,119,,0
2021-01-08 15:00:00,Hispanic or Latino,869,5901,89.0,208,,0
2021-01-09 15:00:00,Hispanic or Latino,195,6096,31.0,239,,0
2021-01-10 15:00:00,Hispanic or Latino,132,6228,21.0,260,,0
2021-01-11 15:00:00,Hispanic or Latino,549,6777,126.0,386,,0
2021-01-12 15:00:00,Hispanic or Latino,728,7505,204.0,590,,0
2021-01-13 15:00:00,Hispanic or Latino,662,8167,131.0,721,,0
2021-01-14 15:00:00,Hispanic or Latino,745,8912,63.0,784,,0
2021-01-15 15:00:00,Hispanic or Latino,873,9785,64.0,848,,0
2021-01-16 15:00:00,Hispanic or Latino,181,9966,43.0,891,,0
2021-01-17 15:00:00,Hispanic or Latino,99,10065,38.0,929,,0
2021-01-18 15:00:00,Hispanic or Latino,169,10234,110.0,1039,,0
2021-01-19 15:00:00,Hispanic or Latino,456,10690,146.0,1185,,0
2021-01-20 15:00:00,Hispanic or Latino,617,11307,172.0,1357,,0
2021-01-21 15:00:00,Hispanic or Latino,752,12059,113.0,1470,,0
2021-01-22 15:00:00,Hispanic or Latino,952,13011,101.0,1571,,0
2021-01-23 15:00:00,Hispanic or Latino,329,13340,49.0,1620,,0
2021-01-24 15:00:00,Hispanic or Latino,97,13437,37.0,1657,,0
2021-01-25 15:00:00,Hispanic or Latino,371,13808,300.0,1957,,0
2021-01-26 15:00:00,Hispanic or Latino,500,14308,225.0,2182,,0
2021-01-27 15:00:00,Hispanic or Latino,744,15052,430.0,2612,,0
2021-01-28 15:00:00,Hispanic or Latino,790,15842,386.0,2998,,0
2021-01-29 15:00:00,Hispanic or Latino,686,16528,289.0,3287,,0
2021-01-30 15:00:00,Hispanic or Latino,481,17009,89.0,3376,,0
2021-01-31 15:00:00,Hispanic or Latino,131,17140,27.0,3403,,0
2021-02-01 15:00:00,Hispanic or Latino,160,17300,146.0,3549,,0
2021-02-02 15:00:00,Hispanic or Latino,413,17713,589.0,4138,,0
2021-02-03 15:00:00,Hispanic or Latino,607,18320,669.0,4807,,0
2021-02-04 15:00:00,Hispanic or Latino,721,19041,709.0,5516,,0
2021-02-05 15:00:00,Hispanic or Latino,753,19794,869.0,6385,,0
2021-02-06 15:00:00,Hispanic or Latino,383,20177,203.0,6588,,0
2021-02-07 15:00:00,Hispanic or Latino,168,20345,58.0,6646,,0
2021-02-08 15:00:00,Hispanic or Latino,522,20867,585.0,7231,,0
2021-02-09 15:00:00,Hispanic or Latino,547,21414,511.0,7742,,0
2021-02-10 15:00:00,Hispanic or Latino,692,22106,679.0,8421,,0
2021-02-11 15:00:00,Hispanic or Latino,860,22966,720.0,9141,,0
2021-02-12 15:00:00,Hispanic or Latino,761,23727,843.0,9984,,0
2021-02-13 15:00:00,Hispanic or Latino,364,24091,222.0,10206,,0
2021-02-14 15:00:00,Hispanic or Latino,275,24366,63.0,10269,,0
2021-02-15 15:00:00,Hispanic or Latino,318,24684,358.0,10627,,0
2021-02-16 15:00:00,Hispanic or Latino,502,25186,541.0,11168,,0
2021-02-17 15:00:00,Hispanic or Latino,691,25877,734.0,11902,,0
2021-02-18 15:00:00,Hispanic or Latino,115,25992,126.0,12028,,0
2021-02-19 15:00:00,Hispanic or Latino,378,26370,746.0,12774,,0
2021-02-20 15:00:00,Hispanic or Latino,368,26738,623.0,13397,,0
2021-02-21 15:00:00,Hispanic or Latino,308,27046,238.0,13635,,0
2021-02-22 15:00:00,Hispanic or Latino,291,27337,405.0,14040,,0
2021-02-23 15:00:00,Hispanic or Latino,520,27857,479.0,14519,,0
2021-02-24 15:00:00,Hispanic or Latino,560,28417,800.0,15319,,0
2021-02-25 15:00:00,Hispanic or Latino,768,29185,811.0,16130,,0
2021-02-26 15:00:00,Hispanic or Latino,1107,30292,833.0,16963,,0
2021-02-27 15:00:00,Hispanic or Latino,659,30951,336.0,17299,,0
2021-02-28 15:00:00,Hispanic or Latino,715,31666,176.0,17475,,0
2021-03-01 15:00:00,Hispanic or Latino,1103,32769,407.0,17882,,0
2021-03-02 15:00:00,Hispanic or Latino,1041,33810,339.0,18221,,0
2021-03-03 15:00:00,Hispanic or Latino,1135,34945,643.0,18864,13.0,13
2021-03-04 15:00:00,Hispanic or Latino,1339,36284,479.0,19343,151.0,164
2021-03-05 15:00:00,Hispanic or Latino,1629,37913,597.0,19940,200.0,364
2021-03-06 15:00:00,Hispanic or Latino,890,38803,277.0,20217,384.0,748
2021-03-07 15:00:00,Hispanic or Latino,569,39372,196.0,20413,287.0,1035
2021-03-08 15:00:00,Hispanic or Latino,1191,40563,297.0,20710,362.0,1397
2021-03-09 15:00:00,Hispanic or Latino,1214,41777,479.0,21189,435.0,1832
2021-03-10 15:00:00,Hispanic or Latino,1355,43132,610.0,21799,520.0,2352
2021-03-11 15:00:00,Hispanic or Latino,1516,44648,660.0,22459,253.0,2605
2021-03-12 15:00:00,Hispanic or Latino,2062,46710,648.0,23107,217.0,2822
2021-03-13 15:00:00,Hispanic or Latino,1213,47923,385.0,23492,211.0,3033
2021-03-14 15:00:00,Hispanic or Latino,1519,49442,207.0,23699,108.0,3141
2021-03-15 15:00:00,Hispanic or Latino,1759,51201,336.0,24035,42.0,3183
2021-03-16 15:00:00,Hispanic or Latino,2027,53228,411.0,24446,21.0,3204
2021-03-17 15:00:00,Hispanic or Latino,2462,55690,571.0,25017,59.0,3263
2021-03-18 15:00:00,Hispanic or Latino,2589,58279,387.0,25404,99.0,3362
2021-03-19 15:00:00,Hispanic or Latino,2600,60879,523.0,25927,83.0,3445
2021-03-20 15:00:00,Hispanic or Latino,2111,62990,410.0,26337,45.0,3490
2021-03-21 15:00:00,Hispanic or Latino,1612,64602,438.0,26775,13.0,3503
2021-03-22 15:00:00,Hispanic or Latino,2200,66802,429.0,27204,31.0,3534
2021-03-23 15:00:00,Hispanic or Latino,2610,69412,607.0,27811,134.0,3668
2021-03-24 15:00:00,Hispanic or Latino,3183,72595,819.0,28630,203.0,3871
2021-03-25 15:00:00,Hispanic or Latino,3329,75924,819.0,29449,113.0,3984
2021-03-26 15:00:00,Hispanic or Latino,2483,78407,1231.0,30680,200.0,4184
2021-03-27 15:00:00,Hispanic or Latino,2217,80624,803.0,31483,137.0,4321
2021-03-28 15:00:00,Hispanic or Latino,1112,81736,531.0,32014,70.0,4391
2021-03-29 15:00:00,Hispanic or Latino,1991,83727,1204.0,33218,59.0,4450
2021-03-30 15:00:00,Hispanic or Latino,2707,86434,1165.0,34383,108.0,4558
2021-03-31 15:00:00,Hispanic or Latino,3382,89816,1317.0,35700,384.0,4942
2021-04-01 15:00:00,Hispanic or Latino,2848,92664,1643.0,37343,291.0,5233
2021-04-02 15:00:00,Hispanic or Latino,2738,95402,1856.0,39199,328.0,5561
2021-04-03 15:00:00,Hispanic or Latino,2107,97509,979.0,40178,274.0,5835
2021-04-04 15:00:00,Hispanic or Latino,692,98201,562.0,40740,47.0,5882
2021-04-05 15:00:00,Hispanic or Latino,2280,100481,1491.0,42231,358.0,6240
2021-04-06 15:00:00,Hispanic or Latino,3098,103579,1769.0,44000,509.0,6749
2021-04-07 15:00:00,Hispanic or Latino,3530,107109,1711.0,45711,844.0,7593
2021-04-08 15:00:00,Hispanic or Latino,3310,110419,1887.0,47598,1201.0,8794
2021-04-09 15:00:00,Hispanic or Latino,3221,113640,2170.0,49768,1090.0,9884
2021-04-10 15:00:00,Hispanic or Latino,2193,115833,1554.0,51322,602.0,10486
2021-04-11 15:00:00,Hispanic or Latino,2140,117973,1304.0,52626,640.0,11126
2021-04-12 15:00:00,Hispanic or Latino,2136,120109,2086.0,54712,775.0,11901
2021-04-13 15:00:00,Hispanic or Latino,3618,123727,2486.0,57198,30.0,11931
2021-04-14 15:00:00,Hispanic or Latino,4410,128137,2569.0,59767,35.0,11966
2021-04-15 15:00:00,Hispanic or Latino,3660,131797,2226.0,61993,25.0,11991
2021-04-16 15:00:00,Hispanic or Latino,3713,135510,2793.0,64786,,11991
2021-04-17 15:00:00,Hispanic or Latino,3662,139172,1819.0,66605,,11991
2021-04-18 15:00:00,Hispanic or Latino,2355,141527,1181.0,67786,,11991
2021-04-19 15:00:00,Hispanic or Latino,3343,144870,1874.0,69660,4.0,11995
2021-04-20 15:00:00,Hispanic or Latino,3540,148410,2401.0,72061,,11995
2021-04-21 15:00:00,Hispanic or Latino,4923,153333,3052.0,75113,,11995
2021-04-22 15:00:00,Hispanic or Latino,3907,157240,3113.0,78226,,11995
2021-04-23 15:00:00,Hispanic or Latino,3599,160839,2993.0,81219,,11995
2021-04-24 15:00:00,Hispanic or Latino,4283,165122,2543.0,83762,6.0,12001
2021-04-25 15:00:00,Hispanic or Latino,2845,167967,809.0,84571,3.0,12004
2021-04-26 15:00:00,Hispanic or Latino,3500,171467,2369.0,86940,15.0,12019
2021-04-27 15:00:00,Hispanic or Latino,3478,174945,2546.0,89486,113.0,12132
2021-04-28 15:00:00,Hispanic or Latino,3578,178523,3579.0,93065,142.0,12274
2021-04-29 15:00:00,Hispanic or Latino,3475,181998,3029.0,96094,151.0,12425
2021-04-30 15:00:00,Hispanic or Latino,4034,186032,2679.0,98773,169.0,12594
2021-05-01 15:00:00,Hispanic or Latino,3356,189388,2192.0,100965,129.0,12723
2021-05-02 15:00:00,Hispanic or Latino,1576,190964,1583.0,102548,126.0,12849
2021-05-03 15:00:00,Hispanic or Latino,1889,192853,2152.0,104700,238.0,13087
2021-05-04 15:00:00,Hispanic or Latino,1799,194652,3072.0,107772,175.0,13262
2021-05-05 15:00:00,Hispanic or Latino,2780,197432,3706.0,111478,217.0,13479
2021-05-06 15:00:00,Hispanic or Latino,2135,199567,3369.0,114847,165.0,13644
2021-05-07 15:00:00,Hispanic or Latino,2925,202492,3352.0,118199,191.0,13835
2021-05-08 15:00:00,Hispanic or Latino,1968,204460,3069.0,121268,172.0,14007
2021-05-09 15:00:00,Hispanic or Latino,933,205393,1427.0,122695,100.0,14107
2021-05-10 15:00:00,Hispanic or Latino,1269,206662,3026.0,125721,134.0,14241
2021-05-11 15:00:00,Hispanic or Latino,1714,208376,2960.0,128681,153.0,14394
2021-05-12 15:00:00,Hispanic or Latino,2210,210586,4130.0,132811,332.0,14726
2021-05-13 15:00:00,Hispanic or Latino,2364,212950,3330.0,136141,117.0,14843
2021-05-14 15:00:00,Hispanic or Latino,3245,216195,2800.0,138941,184.0,15027
2021-05-15 15:00:00,Hispanic or Latino,2933,219128,3050.0,141991,227.0,15254
2021-05-16 15:00:00,Hispanic or Latino,1326,220454,2214.0,144205,196.0,15450
2021-05-17 15:00:00,Hispanic or Latino,1761,222215,2824.0,147029,180.0,15630
2021-05-18 15:00:00,Hispanic or Latino,1638,223853,2340.0,149369,146.0,15776
2021-05-19 15:00:00,Hispanic or Latino,1751,225604,1752.0,151121,141.0,15917
2021-04-02 15:00:00,Unknown,1893,88902,1275.0,41824,764.0,6851
2021-04-03 15:00:00,Unknown,1665,90567,841.0,42665,679.0,7530
2021-04-04 15:00:00,Unknown,622,91189,714.0,43379,46.0,7576
2021-04-05 15:00:00,Unknown,1853,93042,1126.0,44505,679.0,8255
2021-04-06 15:00:00,Unknown,2235,95277,1256.0,45761,896.0,9151
2021-04-07 15:00:00,Unknown,2470,97747,1325.0,47086,1360.0,10511
2021-04-08 15:00:00,Unknown,3098,100845,1508.0,48594,1523.0,12034
2021-04-09 15:00:00,Unknown,3339,104184,1078.0,49672,1298.0,13332
2021-04-10 15:00:00,Unknown,2799,106983,1062.0,50734,1005.0,14337
2021-04-11 15:00:00,Unknown,2519,109502,1077.0,51811,871.0,15208
2021-04-12 15:00:00,Unknown,2849,112351,1880.0,53691,1103.0,16311
2021-04-13 15:00:00,Unknown,3363,115714,1904.0,55595,32.0,16343
2021-04-14 15:00:00,Unknown,3203,118917,2183.0,57778,10.0,16353
2021-04-15 15:00:00,Unknown,3838,122755,2323.0,60101,14.0,16367
2021-04-16 15:00:00,Unknown,3429,126184,2397.0,62498,1.0,16368
2021-04-17 15:00:00,Unknown,3725,129909,1671.0,64169,1.0,16369
2021-04-18 15:00:00,Unknown,2996,132905,1717.0,65886,,16369
2021-04-19 15:00:00,Unknown,2885,135790,2438.0,68324,3.0,16372
2021-04-20 15:00:00,Unknown,2362,138152,2186.0,70510,,16372
2021-04-21 15:00:00,Unknown,3123,141275,2515.0,73025,,16372
2021-04-22 15:00:00,Unknown,2927,144202,1291.0,74316,,16372
2021-04-23 15:00:00,Unknown,3459,147661,1983.0,76299,2.0,16374
2021-04-24 15:00:00,Unknown,3287,150948,1556.0,77855,3.0,16377
2021-04-25 15:00:00,Unknown,2502,153450,773.0,78628,,16377
2021-04-26 15:00:00,Unknown,1942,155392,1524.0,80152,11.0,16388
2021-04-27 15:00:00,Unknown,2559,157951,1464.0,81616,80.0,16468
2021-04-28 15:00:00,Unknown,2296,160247,2578.0,84194,94.0,16562
2021-04-29 15:00:00,Unknown,2121,162368,2712.0,86906,78.0,16640
2021-04-30 15:00:00,Unknown,2225,164593,2793.0,89699,113.0,16753
2021-05-01 15:00:00,Unknown,1722,166315,2621.0,92320,58.0,16811
2021-05-02 15:00:00,Unknown,1347,167662,2272.0,94592,38.0,16849
2021-05-03 15:00:00,Unknown,922,168584,2797.0,97389,92.0,16941
2021-05-04 15:00:00,Unknown,893,169477,3050.0,100439,104.0,17045
2021-05-05 15:00:00,Unknown,1552,171029,2975.0,103414,117.0,17162
2021-05-06 15:00:00,Unknown,1371,172400,3328.0,106742,91.0,17253
2021-05-07 15:00:00,Unknown,1451,173851,2860.0,109602,105.0,17358
2021-05-08 15:00:00,Unknown,1113,174964,3191.0,112793,109.0,17467
2021-05-09 15:00:00,Unknown,735,175699,1562.0,114355,36.0,17503
2021-05-10 15:00:00,Unknown,727,176426,2911.0,117266,72.0,17575
2021-05-11 15:00:00,Unknown,859,177285,2328.0,119594,79.0,17654
2021-05-12 15:00:00,Unknown,1054,178339,2735.0,122329,155.0,17809
2021-05-13 15:00:00,Unknown,1252,179591,2374.0,124703,142.0,17951
2021-05-14 15:00:00,Unknown,1377,180968,2397.0,127100,186.0,18137
2021-05-15 15:00:00,Unknown,1601,182569,2501.0,129601,237.0,18374
2021-05-16 15:00:00,Unknown,702,183271,2160.0,131761,207.0,18581
2021-05-17 15:00:00,Unknown,750,184021,1645.0,133406,229.0,18810
2021-05-18 15:00:00,Unknown,909,184930,2356.0,135762,164.0,18974
2021-05-19 15:00:00,Unknown,1070,186000,2142.0,137904,193.0,19167
2020-12-14 15:00:00,Not Hispanic or Latino,2,2,,0,,0
2020-12-15 15:00:00,Not Hispanic or Latino,12,14,1.0,1,,0
2020-12-16 15:00:00,Not Hispanic or Latino,520,534,2.0,3,,0
2020-12-17 15:00:00,Not Hispanic or Latino,1009,1543,,3,,0
2020-12-18 15:00:00,Not Hispanic or Latino,2695,4238,2.0,5,,0
2020-12-19 15:00:00,Not Hispanic or Latino,793,5031,1.0,6,,0
2020-12-20 15:00:00,Not Hispanic or Latino,245,5276,2.0,8,,0
2020-12-21 15:00:00,Not Hispanic or Latino,3509,8785,2.0,10,,0
2020-12-22 15:00:00,Not Hispanic or Latino,5518,14303,1.0,11,,0
2020-12-23 15:00:00,Not Hispanic or Latino,5106,19409,9.0,20,,0
2020-12-24 15:00:00,Not Hispanic or Latino,2494,21903,4.0,24,,0
2020-12-25 15:00:00,Not Hispanic or Latino,809,22712,2.0,26,,0
2020-12-26 15:00:00,Not Hispanic or Latino,1424,24136,3.0,29,,0
2020-12-27 15:00:00,Not Hispanic or Latino,1571,25707,4.0,33,,0
2020-12-28 15:00:00,Not Hispanic or Latino,8085,33792,9.0,42,,0
2020-12-29 15:00:00,Not Hispanic or Latino,9551,43343,6.0,48,,0
2020-12-30 15:00:00,Not Hispanic or Latino,11330,54673,16.0,64,,0
2020-12-31 15:00:00,Not Hispanic or Latino,6807,61480,9.0,73,,0
2021-01-01 15:00:00,Not Hispanic or Latino,1445,62925,29.0,102,,0
2021-01-02 15:00:00,Not Hispanic or Latino,2387,65312,21.0,123,,0
2021-01-03 15:00:00,Not Hispanic or Latino,2827,68139,62.0,185,,0
2021-01-04 15:00:00,Not Hispanic or Latino,11656,79795,237.0,422,,0
2021-01-05 15:00:00,Not Hispanic or Latino,10885,90680,406.0,828,,0
2021-01-06 15:00:00,Not Hispanic or Latino,13454,104134,732.0,1560,,0
2021-01-07 15:00:00,Not Hispanic or Latino,13433,117567,1487.0,3047,,0
2021-01-08 15:00:00,Not Hispanic or Latino,14444,132011,2400.0,5447,,0
2021-01-09 15:00:00,Not Hispanic or Latino,4448,136459,799.0,6246,,0
2021-01-10 15:00:00,Not Hispanic or Latino,2439,138898,310.0,6556,,0
2021-01-11 15:00:00,Not Hispanic or Latino,12447,151345,3060.0,9616,,0
2021-01-12 15:00:00,Not Hispanic or Latino,15497,166842,4778.0,14394,,0
2021-01-13 15:00:00,Not Hispanic or Latino,16922,183764,3436.0,17830,,0
2021-01-14 15:00:00,Not Hispanic or Latino,16276,200040,1708.0,19538,,0
2021-01-15 15:00:00,Not Hispanic or Latino,17564,217604,1571.0,21109,,0
2021-01-16 15:00:00,Not Hispanic or Latino,5017,222621,1314.0,22423,,0
2021-01-17 15:00:00,Not Hispanic or Latino,1893,224514,1188.0,23611,,0
2021-01-18 15:00:00,Not Hispanic or Latino,6778,231292,2574.0,26185,,0
2021-01-19 15:00:00,Not Hispanic or Latino,15686,246978,4271.0,30456,,0
2021-01-20 15:00:00,Not Hispanic or Latino,19581,266559,4489.0,34945,,0
2021-01-21 15:00:00,Not Hispanic or Latino,21810,288369,3088.0,38033,,0
2021-01-22 15:00:00,Not Hispanic or Latino,26647,315016,2994.0,41027,,0
2021-01-23 15:00:00,Not Hispanic or Latino,8750,323766,1342.0,42369,,0
2021-01-24 15:00:00,Not Hispanic or Latino,2982,326748,1374.0,43743,,0
2021-01-25 15:00:00,Not Hispanic or Latino,15324,342072,7311.0,51054,,0
2021-01-26 15:00:00,Not Hispanic or Latino,16201,358273,7861.0,58915,,0
2021-01-27 15:00:00,Not Hispanic or Latino,22818,381091,11076.0,69991,,0
2021-01-28 15:00:00,Not Hispanic or Latino,21082,402173,8278.0,78269,,0
2021-01-29 15:00:00,Not Hispanic or Latino,22535,424708,6473.0,84742,,0
2021-01-30 15:00:00,Not Hispanic or Latino,16698,441406,2167.0,86909,,0
2021-01-31 15:00:00,Not Hispanic or Latino,3180,444586,1102.0,88011,,0
2021-02-01 15:00:00,Not Hispanic or Latino,5925,450511,3826.0,91837,,0
2021-02-02 15:00:00,Not Hispanic or Latino,10825,461336,12028.0,103865,,0
2021-02-03 15:00:00,Not Hispanic or Latino,16242,477578,16422.0,120287,,0
2021-02-04 15:00:00,Not Hispanic or Latino,20085,497663,14091.0,134378,,0
2021-02-05 15:00:00,Not Hispanic or Latino,18457,516120,15633.0,150011,,0
2021-02-06 15:00:00,Not Hispanic or Latino,10232,526352,5757.0,155768,,0
2021-02-07 15:00:00,Not Hispanic or Latino,5270,531622,1491.0,157259,,0
2021-02-08 15:00:00,Not Hispanic or Latino,11375,542997,11575.0,168834,,0
2021-02-09 15:00:00,Not Hispanic or Latino,15066,558063,12448.0,181282,,0
2021-02-10 15:00:00,Not Hispanic or Latino,17531,575594,19579.0,200861,,0
2021-02-11 15:00:00,Not Hispanic or Latino,20984,596578,15721.0,216582,,0
2021-02-12 15:00:00,Not Hispanic or Latino,18359,614937,17691.0,234273,,0
2021-02-13 15:00:00,Not Hispanic or Latino,10272,625209,5593.0,239866,,0
2021-02-14 15:00:00,Not Hispanic or Latino,6268,631477,1766.0,241632,,0
2021-02-15 15:00:00,Not Hispanic or Latino,10627,642104,11576.0,253208,,0
2021-02-16 15:00:00,Not Hispanic or Latino,15205,657309,19287.0,272495,,0
2021-02-17 15:00:00,Not Hispanic or Latino,19015,676324,24544.0,297039,,0
2021-02-18 15:00:00,Not Hispanic or Latino,2813,679137,3860.0,300899,,0
2021-02-19 15:00:00,Not Hispanic or Latino,9759,688896,17742.0,318641,,0
2021-02-20 15:00:00,Not Hispanic or Latino,9235,698131,18753.0,337394,,0
2021-02-21 15:00:00,Not Hispanic or Latino,5418,703549,6755.0,344149,,0
2021-02-22 15:00:00,Not Hispanic or Latino,7309,710858,14085.0,358234,,0
2021-02-23 15:00:00,Not Hispanic or Latino,14282,725140,14466.0,372700,,0
2021-02-24 15:00:00,Not Hispanic or Latino,16596,741736,22925.0,395625,,0
2021-02-25 15:00:00,Not Hispanic or Latino,18694,760430,24439.0,420064,,0
2021-02-26 15:00:00,Not Hispanic or Latino,24526,784956,23884.0,443948,,0
2021-02-27 15:00:00,Not Hispanic or Latino,14495,799451,10226.0,454174,,0
2021-02-28 15:00:00,Not Hispanic or Latino,14054,813505,4101.0,458275,,0
2021-03-01 15:00:00,Not Hispanic or Latino,22308,835813,10454.0,468729,,0
2021-03-02 15:00:00,Not Hispanic or Latino,21516,857329,11824.0,480553,14.0,14
2021-03-03 15:00:00,Not Hispanic or Latino,27230,884559,16538.0,497091,131.0,145
2021-03-04 15:00:00,Not Hispanic or Latino,28127,912686,16512.0,513603,3806.0,3951
2021-03-05 15:00:00,Not Hispanic or Latino,25746,938432,17548.0,531151,4557.0,8508
2021-03-06 15:00:00,Not Hispanic or Latino,15966,954398,8038.0,539189,5378.0,13886
2021-03-07 15:00:00,Not Hispanic or Latino,10760,965158,3982.0,543171,5975.0,19861
2021-03-08 15:00:00,Not Hispanic or Latino,23231,988389,7755.0,550926,7454.0,27315
2021-03-09 15:00:00,Not Hispanic or Latino,23528,1011917,14009.0,564935,7437.0,34752
2021-03-10 15:00:00,Not Hispanic or Latino,26967,1038884,14378.0,579313,6878.0,41630
2021-03-11 15:00:00,Not Hispanic or Latino,31139,1070023,14766.0,594079,3418.0,45048
2021-03-12 15:00:00,Not Hispanic or Latino,33372,1103395,16032.0,610111,2434.0,47482
2021-03-13 15:00:00,Not Hispanic or Latino,20421,1123816,9093.0,619204,1210.0,48692
2021-03-14 15:00:00,Not Hispanic or Latino,15093,1138909,5944.0,625148,783.0,49475
2021-03-15 15:00:00,Not Hispanic or Latino,25868,1164777,10098.0,635246,472.0,49947
2021-03-16 15:00:00,Not Hispanic or Latino,29280,1194057,12060.0,647306,693.0,50640
2021-03-17 15:00:00,Not Hispanic or Latino,32942,1226999,15199.0,662505,1017.0,51657
2021-03-18 15:00:00,Not Hispanic or Latino,36437,1263436,11142.0,673647,1137.0,52794
2021-03-19 15:00:00,Not Hispanic or Latino,33406,1296842,13928.0,687575,873.0,53667
2021-03-20 15:00:00,Not Hispanic or Latino,20722,1317564,8866.0,696441,584.0,54251
2021-03-21 15:00:00,Not Hispanic or Latino,16074,1333638,6572.0,703013,272.0,54523
2021-03-22 15:00:00,Not Hispanic or Latino,28339,1361977,10017.0,713030,752.0,55275
2021-03-23 15:00:00,Not Hispanic or Latino,32634,1394611,15494.0,728524,1294.0,56569
2021-03-24 15:00:00,Not Hispanic or Latino,34754,1429365,19066.0,747590,1068.0,57637
2021-03-25 15:00:00,Not Hispanic or Latino,35898,1465263,18790.0,766380,2003.0,59640
2021-03-26 15:00:00,Not Hispanic or Latino,31279,1496542,23246.0,789626,1931.0,61571
2021-03-27 15:00:00,Not Hispanic or Latino,22716,1519258,15075.0,804701,1837.0,63408
2021-03-28 15:00:00,Not Hispanic or Latino,13886,1533144,11257.0,815958,1106.0,64514
2021-03-29 15:00:00,Not Hispanic or Latino,24890,1558034,23419.0,839377,985.0,65499
2021-03-30 15:00:00,Not Hispanic or Latino,34200,1592234,25989.0,865366,1594.0,67093
2021-03-31 15:00:00,Not Hispanic or Latino,34677,1626911,31507.0,896873,4511.0,71604
2021-04-01 15:00:00,Not Hispanic or Latino,35766,1662677,33700.0,930573,4512.0,76116
2021-04-02 15:00:00,Not Hispanic or Latino,29789,1692466,28328.0,958901,4670.0,80786
2021-04-03 15:00:00,Not Hispanic or Latino,17633,1710099,16325.0,975226,3369.0,84155
2021-04-04 15:00:00,Not Hispanic or Latino,6976,1717075,8626.0,983852,817.0,84972
2021-04-05 15:00:00,Not Hispanic or Latino,23346,1740421,25513.0,1009365,5543.0,90515
2021-04-06 15:00:00,Not Hispanic or Latino,34148,1774569,26577.0,1035942,9027.0,99542
2021-04-07 15:00:00,Not Hispanic or Latino,29554,1804123,30194.0,1066136,10444.0,109986
2021-04-08 15:00:00,Not Hispanic or Latino,35433,1839556,31917.0,1098053,10931.0,120917
2021-04-09 15:00:00,Not Hispanic or Latino,27031,1866587,32231.0,1130284,12007.0,132924
2021-04-10 15:00:00,Not Hispanic or Latino,18227,1884814,20046.0,1150330,5922.0,138846
2021-04-11 15:00:00,Not Hispanic or Latino,12790,1897604,10679.0,1161009,8548.0,147394
2021-04-12 15:00:00,Not Hispanic or Latino,19222,1916826,28538.0,1189547,8959.0,156353
2021-04-13 15:00:00,Not Hispanic or Latino,35312,1952138,31304.0,1220851,275.0,156628
2021-04-14 15:00:00,Not Hispanic or Latino,32326,1984464,32269.0,1253120,156.0,156784
2021-04-15 15:00:00,Not Hispanic or Latino,33041,2017505,32875.0,1285995,108.0,156892
2021-04-16 15:00:00,Not Hispanic or Latino,28950,2046455,31770.0,1317765,9.0,156901
2021-04-17 15:00:00,Not Hispanic or Latino,24135,2070590,16868.0,1334633,4.0,156905
2021-04-18 15:00:00,Not Hispanic or Latino,14211,2084801,12889.0,1347522,3.0,156908
2021-04-19 15:00:00,Not Hispanic or Latino,21889,2106690,29316.0,1376838,45.0,156953
2021-04-20 15:00:00,Not Hispanic or Latino,22718,2129408,35496.0,1412334,32.0,156985
2021-04-21 15:00:00,Not Hispanic or Latino,28286,2157694,36072.0,1448406,15.0,157000
2021-04-22 15:00:00,Not Hispanic or Latino,27720,2185414,34188.0,1482594,15.0,157015
2021-04-23 15:00:00,Not Hispanic or Latino,23675,2209089,32612.0,1515206,10.0,157025
2021-04-24 15:00:00,Not Hispanic or Latino,18661,2227750,23297.0,1538503,63.0,157088
2021-04-25 15:00:00,Not Hispanic or Latino,13819,2241569,6596.0,1545099,21.0,157109
2021-04-26 15:00:00,Not Hispanic or Latino,19619,2261188,25850.0,1570949,177.0,157286
2021-04-27 15:00:00,Not Hispanic or Latino,20270,2281458,27959.0,1598908,899.0,158185
2021-04-28 15:00:00,Not Hispanic or Latino,22060,2303518,31443.0,1630351,1116.0,159301
2021-04-29 15:00:00,Not Hispanic or Latino,20601,2324119,31023.0,1661374,1194.0,160495
2021-04-30 15:00:00,Not Hispanic or Latino,20762,2344881,25067.0,1686441,1314.0,161809
2021-05-01 15:00:00,Not Hispanic or Latino,12837,2357718,17647.0,1704088,767.0,162576
2021-05-02 15:00:00,Not Hispanic or Latino,6214,2363932,11049.0,1715137,627.0,163203
2021-05-03 15:00:00,Not Hispanic or Latino,9873,2373805,21315.0,1736452,1562.0,164765
2021-05-04 15:00:00,Not Hispanic or Latino,10751,2384556,31121.0,1767573,1434.0,166199
2021-05-05 15:00:00,Not Hispanic or Latino,13611,2398167,28275.0,1795848,1556.0,167755
2021-05-06 15:00:00,Not Hispanic or Latino,13095,2411262,30993.0,1826841,1419.0,169174
2021-05-07 15:00:00,Not Hispanic or Latino,12438,2423700,26794.0,1853635,1606.0,170780
2021-05-08 15:00:00,Not Hispanic or Latino,7022,2430722,22300.0,1875935,991.0,171771
2021-05-09 15:00:00,Not Hispanic or Latino,3450,2434172,8196.0,1884131,553.0,172324
2021-05-10 15:00:00,Not Hispanic or Latino,6414,2440586,22319.0,1906450,1041.0,173365
2021-05-11 15:00:00,Not Hispanic or Latino,8894,2449480,22802.0,1929252,1146.0,174511
2021-05-12 15:00:00,Not Hispanic or Latino,10734,2460214,28565.0,1957817,1336.0,175847
2021-05-13 15:00:00,Not Hispanic or Latino,17293,2477507,25948.0,1983765,1034.0,176881
2021-05-14 15:00:00,Not Hispanic or Latino,18509,2496016,21504.0,2005269,1361.0,178242
2021-05-15 15:00:00,Not Hispanic or Latino,15892,2511908,16602.0,2021871,934.0,179176
2021-05-16 15:00:00,Not Hispanic or Latino,6438,2518346,12178.0,2034049,681.0,179857
2021-05-17 15:00:00,Not Hispanic or Latino,12500,2530846,17894.0,2051943,1342.0,181199
2021-05-18 15:00:00,Not Hispanic or Latino,11037,2541883,14906.0,2066849,876.0,182075
2021-05-19 15:00:00,Not Hispanic or Latino,9414,2551297,11464.0,2078313,595.0,182670
