VACCINATION_DATE,Ethnicity,FirstDoseDaily,FirstDoseCumulative,SecondDoseDaily,SecondDoseCumulative,SingleDoseDaily,SingleDoseCumulative
2020-12-14 15:00:00,Unknown,1,1,,0,,0
2020-12-16 15:00:00,Unknown,10,11,,0,,0
2020-12-17 15:00:00,Unknown,16,27,,0,,0
2020-12-18 15:00:00,Unknown,88,115,,0,,0
2020-12-19 15:00:00,Unknown,27,142,,0,,0
2020-12-20 15:00:00,Unknown,32,174,,0,,0
2020-12-21 15:00:00,Unknown,69,243,,0,,0
2020-12-22 15:00:00,Unknown,434,677,,0,,0
2020-12-23 15:00:00,Unknown,190,867,,0,,0
2020-12-24 15:00:00,Unknown,61,928,,0,,0
2020-12-25 15:00:00,Unknown,189,1117,,0,,0
2020-12-26 15:00:00,Unknown,203,1320,,0,,0
2020-12-27 15:00:00,Unknown,141,1461,,0,,0
2020-12-28 15:00:00,Unknown,290,1751,,0,,0
2020-12-29 15:00:00,Unknown,488,2239,,0,,0
2020-12-30 15:00:00,Unknown,360,2599,,0,,0
2020-12-31 15:00:00,Unknown,207,2806,2.0,2,,0
2021-01-01 15:00:00,Unknown,160,2966,1.0,3,,0
2021-01-02 15:00:00,Unknown,193,3159,2.0,5,,0
2021-01-03 15:00:00,Unknown,258,3417,4.0,9,,0
2021-01-04 15:00:00,Unknown,689,4106,6.0,15,,0
2021-01-05 15:00:00,Unknown,527,4633,17.0,32,,0
2021-01-06 15:00:00,Unknown,668,5301,22.0,54,,0
2021-01-07 15:00:00,Unknown,425,5726,55.0,109,,0
2021-01-08 15:00:00,Unknown,8302,14028,74.0,183,,0
2021-01-09 15:00:00,Unknown,214,14242,40.0,223,,0
2021-01-10 15:00:00,Unknown,184,14426,11.0,234,,0
2021-01-11 15:00:00,Unknown,319,14745,78.0,312,,0
2021-01-12 15:00:00,Unknown,706,15451,356.0,668,,0
2021-01-13 15:00:00,Unknown,416,15867,133.0,801,,0
2021-01-14 15:00:00,Unknown,389,16256,59.0,860,,0
2021-01-15 15:00:00,Unknown,541,16797,181.0,1041,,0
2021-01-16 15:00:00,Unknown,324,17121,165.0,1206,,0
2021-01-17 15:00:00,Unknown,112,17233,105.0,1311,,0
2021-01-18 15:00:00,Unknown,184,17417,221.0,1532,,0
2021-01-19 15:00:00,Unknown,302,17719,250.0,1782,,0
2021-01-20 15:00:00,Unknown,330,18049,153.0,1935,,0
2021-01-21 15:00:00,Unknown,343,18392,71.0,2006,,0
2021-01-22 15:00:00,Unknown,727,19119,213.0,2219,,0
2021-01-23 15:00:00,Unknown,426,19545,163.0,2382,,0
2021-01-24 15:00:00,Unknown,218,19763,170.0,2552,,0
2021-01-25 15:00:00,Unknown,566,20329,506.0,3058,,0
2021-01-26 15:00:00,Unknown,647,20976,363.0,3421,,0
2021-01-27 15:00:00,Unknown,514,21490,566.0,3987,,0
2021-01-28 15:00:00,Unknown,484,21974,274.0,4261,,0
2021-01-29 15:00:00,Unknown,348,22322,174.0,4435,,0
2021-01-30 15:00:00,Unknown,299,22621,48.0,4483,,0
2021-01-31 15:00:00,Unknown,359,22980,86.0,4569,,0
2021-02-01 15:00:00,Unknown,412,23392,182.0,4751,,0
2021-02-02 15:00:00,Unknown,528,23920,624.0,5375,,0
2021-02-03 15:00:00,Unknown,674,24594,496.0,5871,,0
2021-02-04 15:00:00,Unknown,852,25446,404.0,6275,,0
2021-02-05 15:00:00,Unknown,654,26100,415.0,6690,,0
2021-02-06 15:00:00,Unknown,396,26496,8215.0,14905,,0
2021-02-07 15:00:00,Unknown,395,26891,90.0,14995,,0
2021-04-13 15:00:00,Federal Entities,84295,84295,54201.0,54201,2952.0,2952
2021-04-14 15:00:00,Federal Entities,557,84852,11.0,54212,1.0,2953
2021-04-15 15:00:00,Federal Entities,623,85475,823.0,55035,19.0,2972
2021-04-16 15:00:00,Federal Entities,782,86257,1016.0,56051,8.0,2980
2021-04-17 15:00:00,Federal Entities,1136,87393,1177.0,57228,6.0,2986
2021-04-19 15:00:00,Federal Entities,1369,88762,2003.0,59231,9.0,2995
2021-04-20 15:00:00,Federal Entities,3243,92005,2158.0,61389,19.0,3014
2021-04-21 15:00:00,Federal Entities,906,92911,1206.0,62595,4.0,3018
2021-04-22 15:00:00,Federal Entities,1018,93929,458.0,63053,,3018
2021-04-23 15:00:00,Federal Entities,759,94688,632.0,63685,1.0,3019
2021-04-25 15:00:00,Federal Entities,992,95680,2492.0,66177,5.0,3024
2021-04-26 15:00:00,Federal Entities,1483,97163,1672.0,67849,1.0,3025
2021-04-29 15:00:00,Federal Entities,223,97386,865.0,68714,2.0,3027
2021-05-01 15:00:00,Federal Entities,1556,98942,1974.0,70688,14.0,3041
2021-05-02 15:00:00,Federal Entities,1071,100013,1875.0,72563,4.0,3045
2021-05-03 15:00:00,Federal Entities,403,100416,2165.0,74728,4.0,3049
2021-05-04 15:00:00,Federal Entities,28,100444,25.0,74753,,3049
2021-05-05 15:00:00,Federal Entities,365,100809,814.0,75567,,3049
2021-05-06 15:00:00,Federal Entities,275,101084,880.0,76447,3.0,3052
2021-05-07 15:00:00,Federal Entities,274,101358,966.0,77413,8.0,3060
2021-05-08 15:00:00,Federal Entities,297,101655,1312.0,78725,6.0,3066
2021-05-10 15:00:00,Federal Entities,338,101993,1712.0,80437,1.0,3067
2021-05-11 15:00:00,Federal Entities,18,102011,13.0,80450,,3067
2021-05-12 15:00:00,Federal Entities,243,102254,1124.0,81574,,3067
2020-12-15 15:00:00,Hispanic or Latino,2,2,,0,,0
2020-12-16 15:00:00,Hispanic or Latino,18,20,,0,,0
2020-12-17 15:00:00,Hispanic or Latino,32,52,,0,,0
2020-12-18 15:00:00,Hispanic or Latino,84,136,,0,,0
2020-12-19 15:00:00,Hispanic or Latino,33,169,,0,,0
2020-12-20 15:00:00,Hispanic or Latino,8,177,,0,,0
2020-12-21 15:00:00,Hispanic or Latino,148,325,1.0,1,,0
2020-12-22 15:00:00,Hispanic or Latino,251,576,,1,,0
2020-12-23 15:00:00,Hispanic or Latino,181,757,1.0,2,,0
2020-12-24 15:00:00,Hispanic or Latino,89,846,,2,,0
2020-12-25 15:00:00,Hispanic or Latino,37,883,,2,,0
2020-12-26 15:00:00,Hispanic or Latino,39,922,,2,,0
2020-12-27 15:00:00,Hispanic or Latino,58,980,,2,,0
2020-12-28 15:00:00,Hispanic or Latino,258,1238,1.0,3,,0
2020-12-29 15:00:00,Hispanic or Latino,360,1598,1.0,4,,0
2020-12-30 15:00:00,Hispanic or Latino,500,2098,2.0,6,,0
2020-12-31 15:00:00,Hispanic or Latino,311,2409,2.0,8,,0
2021-01-01 15:00:00,Hispanic or Latino,49,2458,2.0,10,,0
2021-01-02 15:00:00,Hispanic or Latino,80,2538,2.0,12,,0
2021-01-03 15:00:00,Hispanic or Latino,118,2656,3.0,15,,0
2021-01-04 15:00:00,Hispanic or Latino,606,3262,11.0,26,,0
2021-01-05 15:00:00,Hispanic or Latino,397,3659,18.0,44,,0
2021-01-06 15:00:00,Hispanic or Latino,576,4235,19.0,63,,0
2021-01-07 15:00:00,Hispanic or Latino,798,5033,55.0,118,,0
2021-01-08 15:00:00,Hispanic or Latino,867,5900,89.0,207,,0
2021-01-09 15:00:00,Hispanic or Latino,196,6096,31.0,238,,0
2021-01-10 15:00:00,Hispanic or Latino,133,6229,20.0,258,,0
2021-01-11 15:00:00,Hispanic or Latino,547,6776,126.0,384,,0
2021-01-12 15:00:00,Hispanic or Latino,726,7502,204.0,588,,0
2021-01-13 15:00:00,Hispanic or Latino,663,8165,130.0,718,,0
2021-01-14 15:00:00,Hispanic or Latino,744,8909,62.0,780,,0
2021-01-15 15:00:00,Hispanic or Latino,873,9782,64.0,844,,0
2021-01-16 15:00:00,Hispanic or Latino,183,9965,41.0,885,,0
2021-01-17 15:00:00,Hispanic or Latino,99,10064,38.0,923,,0
2021-01-18 15:00:00,Hispanic or Latino,171,10235,111.0,1034,,0
2021-01-19 15:00:00,Hispanic or Latino,454,10689,146.0,1180,,0
2021-02-08 15:00:00,Unknown,661,27552,251.0,15246,,0
2021-02-09 15:00:00,Unknown,739,28291,291.0,15537,,0
2021-02-10 15:00:00,Unknown,820,29111,402.0,15939,,0
2021-02-11 15:00:00,Unknown,907,30018,397.0,16336,,0
2021-02-12 15:00:00,Unknown,714,30732,554.0,16890,,0
2021-02-13 15:00:00,Unknown,385,31117,154.0,17044,,0
2021-02-14 15:00:00,Unknown,449,31566,147.0,17191,,0
2021-02-15 15:00:00,Unknown,472,32038,490.0,17681,,0
2021-02-16 15:00:00,Unknown,730,32768,673.0,18354,,0
2021-02-17 15:00:00,Unknown,838,33606,455.0,18809,,0
2021-02-18 15:00:00,Unknown,312,33918,231.0,19040,,0
2021-02-19 15:00:00,Unknown,644,34562,414.0,19454,,0
2021-02-20 15:00:00,Unknown,481,35043,355.0,19809,,0
2021-02-21 15:00:00,Unknown,340,35383,261.0,20070,,0
2021-02-22 15:00:00,Unknown,458,35841,405.0,20475,,0
2021-02-23 15:00:00,Unknown,686,36527,348.0,20823,,0
2021-02-24 15:00:00,Unknown,617,37144,495.0,21318,,0
2021-02-25 15:00:00,Unknown,639,37783,809.0,22127,,0
2021-02-26 15:00:00,Unknown,745,38528,661.0,22788,,0
2021-02-27 15:00:00,Unknown,570,39098,283.0,23071,,0
2021-02-28 15:00:00,Unknown,650,39748,168.0,23239,,0
2021-03-01 15:00:00,Unknown,832,40580,471.0,23710,,0
2021-03-02 15:00:00,Unknown,771,41351,515.0,24225,,0
2021-03-03 15:00:00,Unknown,965,42316,585.0,24810,3.0,3
2021-03-04 15:00:00,Unknown,955,43271,669.0,25479,105.0,108
2021-03-05 15:00:00,Unknown,985,44256,552.0,26031,88.0,196
2021-03-06 15:00:00,Unknown,665,44921,308.0,26339,188.0,384
2021-03-07 15:00:00,Unknown,613,45534,315.0,26654,299.0,683
2021-03-08 15:00:00,Unknown,910,46444,342.0,26996,369.0,1052
2021-03-09 15:00:00,Unknown,869,47313,454.0,27450,381.0,1433
2021-03-10 15:00:00,Unknown,765,48078,498.0,27948,505.0,1938
2021-03-11 15:00:00,Unknown,961,49039,512.0,28460,161.0,2099
2021-03-12 15:00:00,Unknown,1151,50190,548.0,29008,108.0,2207
2021-03-13 15:00:00,Unknown,805,50995,336.0,29344,51.0,2258
2021-03-14 15:00:00,Unknown,972,51967,326.0,29670,60.0,2318
2021-03-15 15:00:00,Unknown,1627,53594,397.0,30067,33.0,2351
2021-03-16 15:00:00,Unknown,1613,55207,584.0,30651,46.0,2397
2021-03-17 15:00:00,Unknown,1610,56817,683.0,31334,63.0,2460
2021-03-18 15:00:00,Unknown,1790,58607,454.0,31788,55.0,2515
2021-03-19 15:00:00,Unknown,1458,60065,424.0,32212,50.0,2565
2021-03-20 15:00:00,Unknown,1287,61352,442.0,32654,36.0,2601
2021-03-21 15:00:00,Unknown,1119,62471,337.0,32991,22.0,2623
2021-03-22 15:00:00,Unknown,1592,64063,494.0,33485,33.0,2656
2021-03-23 15:00:00,Unknown,2005,66068,613.0,34098,75.0,2731
2021-03-24 15:00:00,Unknown,2639,68707,520.0,34618,79.0,2810
2021-03-25 15:00:00,Unknown,2637,71344,589.0,35207,335.0,3145
2021-03-26 15:00:00,Unknown,2607,73951,672.0,35879,363.0,3508
2021-03-27 15:00:00,Unknown,1895,75846,511.0,36390,409.0,3917
2021-03-28 15:00:00,Unknown,1953,77799,506.0,36896,437.0,4354
2021-03-29 15:00:00,Unknown,2708,80507,944.0,37840,75.0,4429
2021-03-30 15:00:00,Unknown,2576,83083,963.0,38803,121.0,4550
2021-03-31 15:00:00,Unknown,2558,85641,847.0,39650,812.0,5362
2021-04-01 15:00:00,Unknown,1847,87488,980.0,40630,630.0,5992
2021-01-20 15:00:00,Hispanic or Latino,616,11305,172.0,1352,,0
2021-01-21 15:00:00,Hispanic or Latino,751,12056,112.0,1464,,0
2021-01-22 15:00:00,Hispanic or Latino,953,13009,103.0,1567,,0
2021-01-23 15:00:00,Hispanic or Latino,326,13335,48.0,1615,,0
2021-01-24 15:00:00,Hispanic or Latino,98,13433,37.0,1652,,0
2021-01-25 15:00:00,Hispanic or Latino,371,13804,302.0,1954,,0
2021-01-26 15:00:00,Hispanic or Latino,499,14303,225.0,2179,,0
2021-01-27 15:00:00,Hispanic or Latino,743,15046,429.0,2608,,0
2021-01-28 15:00:00,Hispanic or Latino,788,15834,384.0,2992,,0
2021-01-29 15:00:00,Hispanic or Latino,686,16520,288.0,3280,,0
2021-01-30 15:00:00,Hispanic or Latino,480,17000,89.0,3369,,0
2021-01-31 15:00:00,Hispanic or Latino,132,17132,26.0,3395,,0
2021-02-01 15:00:00,Hispanic or Latino,159,17291,145.0,3540,,0
2021-02-02 15:00:00,Hispanic or Latino,413,17704,589.0,4129,,0
2021-02-03 15:00:00,Hispanic or Latino,607,18311,673.0,4802,,0
2021-02-04 15:00:00,Hispanic or Latino,721,19032,710.0,5512,,0
2021-02-05 15:00:00,Hispanic or Latino,754,19786,866.0,6378,,0
2021-02-06 15:00:00,Hispanic or Latino,383,20169,203.0,6581,,0
2021-02-07 15:00:00,Hispanic or Latino,169,20338,57.0,6638,,0
2021-02-08 15:00:00,Hispanic or Latino,523,20861,587.0,7225,,0
2021-02-09 15:00:00,Hispanic or Latino,546,21407,510.0,7735,,0
2021-02-10 15:00:00,Hispanic or Latino,690,22097,679.0,8414,,0
2021-02-11 15:00:00,Hispanic or Latino,860,22957,720.0,9134,,0
2021-02-12 15:00:00,Hispanic or Latino,761,23718,842.0,9976,,0
2021-02-13 15:00:00,Hispanic or Latino,360,24078,222.0,10198,,0
2021-02-14 15:00:00,Hispanic or Latino,275,24353,63.0,10261,,0
2021-02-15 15:00:00,Hispanic or Latino,320,24673,355.0,10616,,0
2021-02-16 15:00:00,Hispanic or Latino,503,25176,540.0,11156,,0
2021-02-17 15:00:00,Hispanic or Latino,688,25864,733.0,11889,,0
2021-02-18 15:00:00,Hispanic or Latino,120,25984,122.0,12011,,0
2021-02-19 15:00:00,Hispanic or Latino,379,26363,746.0,12757,,0
2021-02-20 15:00:00,Hispanic or Latino,366,26729,622.0,13379,,0
2021-02-21 15:00:00,Hispanic or Latino,308,27037,237.0,13616,,0
2021-02-22 15:00:00,Hispanic or Latino,293,27330,407.0,14023,,0
2021-02-23 15:00:00,Hispanic or Latino,520,27850,478.0,14501,,0
2021-02-24 15:00:00,Hispanic or Latino,559,28409,797.0,15298,,0
2021-02-25 15:00:00,Hispanic or Latino,765,29174,807.0,16105,,0
2021-02-26 15:00:00,Hispanic or Latino,1106,30280,832.0,16937,,0
2021-02-27 15:00:00,Hispanic or Latino,661,30941,340.0,17277,,0
2021-02-28 15:00:00,Hispanic or Latino,713,31654,176.0,17453,,0
2021-03-01 15:00:00,Hispanic or Latino,1099,32753,408.0,17861,,0
2021-03-02 15:00:00,Hispanic or Latino,1043,33796,337.0,18198,,0
2021-03-03 15:00:00,Hispanic or Latino,1131,34927,643.0,18841,12.0,12
2021-03-04 15:00:00,Hispanic or Latino,1337,36264,480.0,19321,151.0,163
2021-03-05 15:00:00,Hispanic or Latino,1628,37892,596.0,19917,200.0,363
2021-03-06 15:00:00,Hispanic or Latino,893,38785,277.0,20194,383.0,746
2021-03-07 15:00:00,Hispanic or Latino,570,39355,195.0,20389,287.0,1033
2021-03-08 15:00:00,Hispanic or Latino,1192,40547,294.0,20683,361.0,1394
2021-03-09 15:00:00,Hispanic or Latino,1214,41761,479.0,21162,435.0,1829
2021-03-10 15:00:00,Hispanic or Latino,1354,43115,610.0,21772,520.0,2349
2021-03-11 15:00:00,Hispanic or Latino,1505,44620,658.0,22430,238.0,2587
2021-03-12 15:00:00,Hispanic or Latino,1996,46616,621.0,23051,196.0,2783
2021-03-13 15:00:00,Hispanic or Latino,1135,47751,356.0,23407,205.0,2988
2021-03-14 15:00:00,Hispanic or Latino,1401,49152,182.0,23589,107.0,3095
2021-03-15 15:00:00,Hispanic or Latino,1723,50875,327.0,23916,42.0,3137
2021-03-16 15:00:00,Hispanic or Latino,2021,52896,412.0,24328,21.0,3158
2021-03-17 15:00:00,Hispanic or Latino,2463,55359,568.0,24896,58.0,3216
2021-03-18 15:00:00,Hispanic or Latino,2593,57952,383.0,25279,99.0,3315
2021-03-19 15:00:00,Hispanic or Latino,2600,60552,522.0,25801,82.0,3397
2021-03-20 15:00:00,Hispanic or Latino,2112,62664,410.0,26211,45.0,3442
2021-03-21 15:00:00,Hispanic or Latino,1615,64279,436.0,26647,13.0,3455
2021-03-22 15:00:00,Hispanic or Latino,2197,66476,422.0,27069,31.0,3486
2021-03-23 15:00:00,Hispanic or Latino,2596,69072,606.0,27675,134.0,3620
2021-04-02 15:00:00,Unknown,1916,89404,1261.0,41891,763.0,6755
2021-04-03 15:00:00,Unknown,1687,91091,826.0,42717,687.0,7442
2021-04-04 15:00:00,Unknown,678,91769,671.0,43388,46.0,7488
2021-04-05 15:00:00,Unknown,1897,93666,1105.0,44493,676.0,8164
2021-04-06 15:00:00,Unknown,2251,95917,1252.0,45745,899.0,9063
2021-04-07 15:00:00,Unknown,2489,98406,1325.0,47070,1360.0,10423
2021-04-08 15:00:00,Unknown,3110,101516,1504.0,48574,1524.0,11947
2021-04-09 15:00:00,Unknown,3353,104869,1080.0,49654,1295.0,13242
2021-04-10 15:00:00,Unknown,2832,107701,1052.0,50706,1017.0,14259
2021-04-11 15:00:00,Unknown,2562,110263,1060.0,51766,872.0,15131
2021-04-12 15:00:00,Unknown,2889,113152,1874.0,53640,1100.0,16231
2021-04-13 15:00:00,Unknown,3421,116573,1901.0,55541,31.0,16262
2021-04-14 15:00:00,Unknown,3259,119832,2187.0,57728,10.0,16272
2021-04-15 15:00:00,Unknown,3947,123779,2330.0,60058,15.0,16287
2021-04-16 15:00:00,Unknown,3606,127385,2397.0,62455,1.0,16288
2021-04-17 15:00:00,Unknown,3822,131207,1668.0,64123,1.0,16289
2021-04-18 15:00:00,Unknown,3116,134323,1718.0,65841,,16289
2021-04-19 15:00:00,Unknown,2946,137269,2437.0,68278,3.0,16292
2021-04-20 15:00:00,Unknown,2446,139715,2182.0,70460,,16292
2021-04-21 15:00:00,Unknown,3266,142981,2521.0,72981,,16292
2021-04-22 15:00:00,Unknown,3031,146012,1291.0,74272,,16292
2021-04-23 15:00:00,Unknown,3571,149583,1985.0,76257,2.0,16294
2021-04-24 15:00:00,Unknown,3436,153019,1555.0,77812,3.0,16297
2021-04-25 15:00:00,Unknown,2622,155641,777.0,78589,,16297
2021-04-26 15:00:00,Unknown,1910,157551,1439.0,80028,11.0,16308
2021-04-27 15:00:00,Unknown,2465,160016,1338.0,81366,66.0,16374
2021-04-28 15:00:00,Unknown,2308,162324,2566.0,83932,90.0,16464
2021-04-29 15:00:00,Unknown,2106,164430,2704.0,86636,78.0,16542
2021-04-30 15:00:00,Unknown,2223,166653,2792.0,89428,114.0,16656
2021-05-01 15:00:00,Unknown,1703,168356,2618.0,92046,57.0,16713
2021-05-02 15:00:00,Unknown,1348,169704,2275.0,94321,38.0,16751
2021-05-03 15:00:00,Unknown,919,170623,2783.0,97104,91.0,16842
2021-05-04 15:00:00,Unknown,886,171509,3045.0,100149,105.0,16947
2021-05-05 15:00:00,Unknown,1545,173054,2966.0,103115,117.0,17064
2021-05-06 15:00:00,Unknown,1366,174420,3323.0,106438,89.0,17153
2021-05-07 15:00:00,Unknown,1449,175869,2840.0,109278,105.0,17258
2021-05-08 15:00:00,Unknown,1113,176982,3175.0,112453,109.0,17367
2021-05-09 15:00:00,Unknown,736,177718,1539.0,113992,37.0,17404
2021-05-10 15:00:00,Unknown,725,178443,2911.0,116903,72.0,17476
2021-05-11 15:00:00,Unknown,891,179334,2315.0,119218,86.0,17562
2021-05-12 15:00:00,Unknown,856,180190,2569.0,121787,164.0,17726
2021-05-13 15:00:00,Unknown,1227,181417,2117.0,123904,133.0,17859
2020-12-14 15:00:00,Not Hispanic or Latino,2,2,,0,,0
2020-12-15 15:00:00,Not Hispanic or Latino,11,13,1.0,1,,0
2020-12-16 15:00:00,Not Hispanic or Latino,517,530,2.0,3,,0
2020-12-17 15:00:00,Not Hispanic or Latino,1006,1536,,3,,0
2020-12-18 15:00:00,Not Hispanic or Latino,2695,4231,2.0,5,,0
2020-12-19 15:00:00,Not Hispanic or Latino,792,5023,1.0,6,,0
2020-12-20 15:00:00,Not Hispanic or Latino,244,5267,2.0,8,,0
2020-12-21 15:00:00,Not Hispanic or Latino,3507,8774,,8,,0
2020-12-22 15:00:00,Not Hispanic or Latino,5500,14274,1.0,9,,0
2020-12-23 15:00:00,Not Hispanic or Latino,5102,19376,6.0,15,,0
2020-12-24 15:00:00,Not Hispanic or Latino,2494,21870,3.0,18,,0
2020-12-25 15:00:00,Not Hispanic or Latino,804,22674,1.0,19,,0
2021-03-24 15:00:00,Hispanic or Latino,3177,72249,816.0,28491,201.0,3821
2021-03-25 15:00:00,Hispanic or Latino,3327,75576,815.0,29306,113.0,3934
2021-03-26 15:00:00,Hispanic or Latino,2483,78059,1229.0,30535,200.0,4134
2021-03-27 15:00:00,Hispanic or Latino,2217,80276,803.0,31338,137.0,4271
2021-03-28 15:00:00,Hispanic or Latino,1111,81387,531.0,31869,71.0,4342
2021-03-29 15:00:00,Hispanic or Latino,1992,83379,1203.0,33072,58.0,4400
2021-03-30 15:00:00,Hispanic or Latino,2714,86093,1161.0,34233,108.0,4508
2021-03-31 15:00:00,Hispanic or Latino,3376,89469,1318.0,35551,383.0,4891
2021-04-01 15:00:00,Hispanic or Latino,2857,92326,1634.0,37185,288.0,5179
2021-04-02 15:00:00,Hispanic or Latino,2778,95104,1814.0,38999,327.0,5506
2021-04-03 15:00:00,Hispanic or Latino,2158,97262,927.0,39926,271.0,5777
2021-04-04 15:00:00,Hispanic or Latino,759,98021,491.0,40417,47.0,5824
2021-04-05 15:00:00,Hispanic or Latino,2317,100338,1455.0,41872,358.0,6182
2021-04-06 15:00:00,Hispanic or Latino,3101,103439,1756.0,43628,508.0,6690
2021-04-07 15:00:00,Hispanic or Latino,3526,106965,1711.0,45339,845.0,7535
2021-04-08 15:00:00,Hispanic or Latino,3313,110278,1882.0,47221,1199.0,8734
2021-04-09 15:00:00,Hispanic or Latino,3213,113491,2169.0,49390,1089.0,9823
2021-04-10 15:00:00,Hispanic or Latino,2208,115699,1539.0,50929,598.0,10421
2021-04-11 15:00:00,Hispanic or Latino,2154,117853,1288.0,52217,635.0,11056
2021-04-12 15:00:00,Hispanic or Latino,2149,120002,2065.0,54282,771.0,11827
2021-04-13 15:00:00,Hispanic or Latino,3614,123616,2478.0,56760,30.0,11857
2021-04-14 15:00:00,Hispanic or Latino,4400,128016,2560.0,59320,35.0,11892
2021-04-15 15:00:00,Hispanic or Latino,3631,131647,2228.0,61548,25.0,11917
2021-04-16 15:00:00,Hispanic or Latino,3688,135335,2784.0,64332,,11917
2021-04-17 15:00:00,Hispanic or Latino,3618,138953,1819.0,66151,,11917
2021-04-18 15:00:00,Hispanic or Latino,2308,141261,1181.0,67332,,11917
2021-04-19 15:00:00,Hispanic or Latino,3344,144605,1865.0,69197,4.0,11921
2021-04-20 15:00:00,Hispanic or Latino,3521,148126,2387.0,71584,,11921
2021-04-21 15:00:00,Hispanic or Latino,4883,153009,3049.0,74633,,11921
2021-04-22 15:00:00,Hispanic or Latino,3876,156885,3113.0,77746,,11921
2021-04-23 15:00:00,Hispanic or Latino,3609,160494,2989.0,80735,,11921
2021-04-24 15:00:00,Hispanic or Latino,4233,164727,2542.0,83277,7.0,11928
2021-04-25 15:00:00,Hispanic or Latino,2799,167526,806.0,84083,3.0,11931
2021-04-26 15:00:00,Hispanic or Latino,3141,170667,2166.0,86249,15.0,11946
2021-04-27 15:00:00,Hispanic or Latino,3040,173707,2299.0,88548,83.0,12029
2021-04-28 15:00:00,Hispanic or Latino,3462,177169,3520.0,92068,138.0,12167
2021-04-29 15:00:00,Hispanic or Latino,3438,180607,2998.0,95066,149.0,12316
2021-04-30 15:00:00,Hispanic or Latino,4019,184626,2669.0,97735,167.0,12483
2021-05-01 15:00:00,Hispanic or Latino,3299,187925,2173.0,99908,122.0,12605
2021-05-02 15:00:00,Hispanic or Latino,1571,189496,1569.0,101477,126.0,12731
2021-05-03 15:00:00,Hispanic or Latino,1861,191357,2116.0,103593,234.0,12965
2021-05-04 15:00:00,Hispanic or Latino,1763,193120,3058.0,106651,176.0,13141
2021-05-05 15:00:00,Hispanic or Latino,2764,195884,3687.0,110338,215.0,13356
2021-05-06 15:00:00,Hispanic or Latino,2119,198003,3360.0,113698,165.0,13521
2021-05-07 15:00:00,Hispanic or Latino,2904,200907,3257.0,116955,191.0,13712
2021-05-08 15:00:00,Hispanic or Latino,1955,202862,2808.0,119763,173.0,13885
2021-05-09 15:00:00,Hispanic or Latino,934,203796,1410.0,121173,100.0,13985
2021-05-10 15:00:00,Hispanic or Latino,1269,205065,3016.0,124189,134.0,14119
2021-05-11 15:00:00,Hispanic or Latino,1642,206707,2889.0,127078,147.0,14266
2021-05-12 15:00:00,Hispanic or Latino,1643,208350,3575.0,130653,300.0,14566
2021-05-13 15:00:00,Hispanic or Latino,1279,209629,1977.0,132630,62.0,14628
2020-12-26 15:00:00,Not Hispanic or Latino,1412,24086,3.0,22,,0
2020-12-27 15:00:00,Not Hispanic or Latino,1567,25653,4.0,26,,0
2020-12-28 15:00:00,Not Hispanic or Latino,8073,33726,8.0,34,,0
2020-12-29 15:00:00,Not Hispanic or Latino,9490,43216,5.0,39,,0
2020-12-30 15:00:00,Not Hispanic or Latino,11321,54537,12.0,51,,0
2020-12-31 15:00:00,Not Hispanic or Latino,6798,61335,8.0,59,,0
2021-01-01 15:00:00,Not Hispanic or Latino,1422,62757,21.0,80,,0
2021-01-02 15:00:00,Not Hispanic or Latino,2335,65092,19.0,99,,0
2021-01-03 15:00:00,Not Hispanic or Latino,2787,67879,62.0,161,,0
2021-01-04 15:00:00,Not Hispanic or Latino,11549,79428,235.0,396,,0
2021-01-05 15:00:00,Not Hispanic or Latino,10786,90214,406.0,802,,0
2021-01-06 15:00:00,Not Hispanic or Latino,13428,103642,730.0,1532,,0
2021-01-07 15:00:00,Not Hispanic or Latino,13413,117055,1484.0,3016,,0
2021-01-08 15:00:00,Not Hispanic or Latino,14423,131478,2398.0,5414,,0
2021-01-09 15:00:00,Not Hispanic or Latino,4435,135913,800.0,6214,,0
2021-01-10 15:00:00,Not Hispanic or Latino,2429,138342,309.0,6523,,0
2021-01-11 15:00:00,Not Hispanic or Latino,12436,150778,3056.0,9579,,0
2021-01-12 15:00:00,Not Hispanic or Latino,15248,166026,4758.0,14337,,0
2021-01-13 15:00:00,Not Hispanic or Latino,16786,182812,3378.0,17715,,0
2021-01-14 15:00:00,Not Hispanic or Latino,16253,199065,1704.0,19419,,0
2021-01-15 15:00:00,Not Hispanic or Latino,17556,216621,1556.0,20975,,0
2021-01-16 15:00:00,Not Hispanic or Latino,5186,221807,1112.0,22087,,0
2021-01-17 15:00:00,Not Hispanic or Latino,1884,223691,1178.0,23265,,0
2021-01-18 15:00:00,Not Hispanic or Latino,6777,230468,2553.0,25818,,0
2021-01-19 15:00:00,Not Hispanic or Latino,15684,246152,4245.0,30063,,0
2021-01-20 15:00:00,Not Hispanic or Latino,19574,265726,4476.0,34539,,0
2021-01-21 15:00:00,Not Hispanic or Latino,21797,287523,3076.0,37615,,0
2021-01-22 15:00:00,Not Hispanic or Latino,26625,314148,2915.0,40530,,0
2021-01-23 15:00:00,Not Hispanic or Latino,8717,322865,1287.0,41817,,0
2021-01-24 15:00:00,Not Hispanic or Latino,2965,325830,1360.0,43177,,0
2021-01-25 15:00:00,Not Hispanic or Latino,15264,341094,7316.0,50493,,0
2021-01-26 15:00:00,Not Hispanic or Latino,16113,357207,7743.0,58236,,0
2021-01-27 15:00:00,Not Hispanic or Latino,22803,380010,11029.0,69265,,0
2021-01-28 15:00:00,Not Hispanic or Latino,20952,400962,8251.0,77516,,0
2021-01-29 15:00:00,Not Hispanic or Latino,22527,423489,6451.0,83967,,0
2021-01-30 15:00:00,Not Hispanic or Latino,16595,440084,2150.0,86117,,0
2021-01-31 15:00:00,Not Hispanic or Latino,3166,443250,1096.0,87213,,0
2021-02-01 15:00:00,Not Hispanic or Latino,5895,449145,3808.0,91021,,0
2021-02-02 15:00:00,Not Hispanic or Latino,10820,459965,11989.0,103010,,0
2021-02-03 15:00:00,Not Hispanic or Latino,16225,476190,16524.0,119534,,0
2021-02-04 15:00:00,Not Hispanic or Latino,19977,496167,14079.0,133613,,0
2021-02-05 15:00:00,Not Hispanic or Latino,18360,514527,15602.0,149215,,0
2021-02-06 15:00:00,Not Hispanic or Latino,10274,524801,5654.0,154869,,0
2021-02-07 15:00:00,Not Hispanic or Latino,5278,530079,1440.0,156309,,0
2021-02-08 15:00:00,Not Hispanic or Latino,11361,541440,11563.0,167872,,0
2021-02-09 15:00:00,Not Hispanic or Latino,14836,556276,12413.0,180285,,0
2021-02-10 15:00:00,Not Hispanic or Latino,17426,573702,19562.0,199847,,0
2021-02-11 15:00:00,Not Hispanic or Latino,20959,594661,15673.0,215520,,0
2021-02-12 15:00:00,Not Hispanic or Latino,18334,612995,17651.0,233171,,0
2021-02-13 15:00:00,Not Hispanic or Latino,10211,623206,5578.0,238749,,0
2021-02-14 15:00:00,Not Hispanic or Latino,6242,629448,1744.0,240493,,0
2021-02-15 15:00:00,Not Hispanic or Latino,10929,640377,11221.0,251714,,0
2021-02-16 15:00:00,Not Hispanic or Latino,15233,655610,19255.0,270969,,0
2021-02-17 15:00:00,Not Hispanic or Latino,19009,674619,24451.0,295420,,0
2021-02-18 15:00:00,Not Hispanic or Latino,2904,677523,3859.0,299279,,0
2021-02-19 15:00:00,Not Hispanic or Latino,9731,687254,17727.0,317006,,0
2021-02-20 15:00:00,Not Hispanic or Latino,9224,696478,18739.0,335745,,0
2021-02-21 15:00:00,Not Hispanic or Latino,5403,701881,6730.0,342475,,0
2021-02-22 15:00:00,Not Hispanic or Latino,7318,709199,14089.0,356564,,0
2021-02-23 15:00:00,Not Hispanic or Latino,14255,723454,14455.0,371019,,0
2021-02-24 15:00:00,Not Hispanic or Latino,16598,740052,22923.0,393942,,0
2021-02-25 15:00:00,Not Hispanic or Latino,18711,758763,24291.0,418233,,0
2021-02-26 15:00:00,Not Hispanic or Latino,24504,783267,23837.0,442070,,0
2021-02-27 15:00:00,Not Hispanic or Latino,14573,797840,10131.0,452201,,0
2021-02-28 15:00:00,Not Hispanic or Latino,14052,811892,4096.0,456297,,0
2021-03-01 15:00:00,Not Hispanic or Latino,22262,834154,10458.0,466755,,0
2021-03-02 15:00:00,Not Hispanic or Latino,21513,855667,11972.0,478727,13.0,13
2021-03-03 15:00:00,Not Hispanic or Latino,27224,882891,16577.0,495304,127.0,140
2021-03-04 15:00:00,Not Hispanic or Latino,28103,910994,16443.0,511747,3803.0,3943
2021-03-05 15:00:00,Not Hispanic or Latino,25819,936813,17447.0,529194,4555.0,8498
2021-03-06 15:00:00,Not Hispanic or Latino,15975,952788,8033.0,537227,5381.0,13879
2021-03-07 15:00:00,Not Hispanic or Latino,10752,963540,3965.0,541192,5972.0,19851
2021-03-08 15:00:00,Not Hispanic or Latino,23227,986767,7733.0,548925,7452.0,27303
2021-03-09 15:00:00,Not Hispanic or Latino,23483,1010250,13999.0,562924,7435.0,34738
2021-03-10 15:00:00,Not Hispanic or Latino,26925,1037175,14356.0,577280,6874.0,41612
2021-03-11 15:00:00,Not Hispanic or Latino,31021,1068196,14700.0,591980,3299.0,44911
2021-03-12 15:00:00,Not Hispanic or Latino,32650,1100846,15037.0,607017,2206.0,47117
2021-03-13 15:00:00,Not Hispanic or Latino,19445,1120291,8244.0,615261,1128.0,48245
2021-03-14 15:00:00,Not Hispanic or Latino,13998,1134289,4984.0,620245,750.0,48995
2021-03-15 15:00:00,Not Hispanic or Latino,25472,1159761,9749.0,629994,466.0,49461
2021-03-16 15:00:00,Not Hispanic or Latino,29254,1189015,12047.0,642041,692.0,50153
2021-03-17 15:00:00,Not Hispanic or Latino,32926,1221941,15171.0,657212,1016.0,51169
2021-03-18 15:00:00,Not Hispanic or Latino,36417,1258358,11124.0,668336,1135.0,52304
2021-03-19 15:00:00,Not Hispanic or Latino,33389,1291747,13915.0,682251,872.0,53176
2021-03-20 15:00:00,Not Hispanic or Latino,20712,1312459,8850.0,691101,581.0,53757
2021-03-21 15:00:00,Not Hispanic or Latino,16059,1328518,6562.0,697663,270.0,54027
2021-03-22 15:00:00,Not Hispanic or Latino,28302,1356820,10000.0,707663,751.0,54778
2021-03-23 15:00:00,Not Hispanic or Latino,32492,1389312,15455.0,723118,1292.0,56070
2021-03-24 15:00:00,Not Hispanic or Latino,34710,1424022,19020.0,742138,1067.0,57137
2021-03-25 15:00:00,Not Hispanic or Latino,35895,1459917,18756.0,760894,2002.0,59139
2021-03-26 15:00:00,Not Hispanic or Latino,31275,1491192,23210.0,784104,1926.0,61065
2021-03-27 15:00:00,Not Hispanic or Latino,22708,1513900,15062.0,799166,1837.0,62902
2021-03-28 15:00:00,Not Hispanic or Latino,13869,1527769,11249.0,810415,1102.0,64004
2021-03-29 15:00:00,Not Hispanic or Latino,24868,1552637,23376.0,833791,979.0,64983
2021-03-30 15:00:00,Not Hispanic or Latino,34189,1586826,25929.0,859720,1582.0,66565
2021-03-31 15:00:00,Not Hispanic or Latino,34689,1621515,31444.0,891164,4493.0,71058
2021-04-01 15:00:00,Not Hispanic or Latino,35810,1657325,33597.0,924761,4494.0,75552
2021-04-02 15:00:00,Not Hispanic or Latino,30166,1687491,27908.0,952669,4660.0,80212
2021-04-03 15:00:00,Not Hispanic or Latino,18009,1705500,15943.0,968612,3363.0,83575
2021-04-04 15:00:00,Not Hispanic or Latino,7537,1713037,8051.0,976663,814.0,84389
2021-04-05 15:00:00,Not Hispanic or Latino,23719,1736756,25092.0,1001755,5534.0,89923
2021-04-06 15:00:00,Not Hispanic or Latino,34218,1770974,26463.0,1028218,9023.0,98946
2021-04-07 15:00:00,Not Hispanic or Latino,29573,1800547,30131.0,1058349,10428.0,109374
2021-04-08 15:00:00,Not Hispanic or Latino,35416,1835963,31895.0,1090244,10917.0,120291
2021-04-09 15:00:00,Not Hispanic or Latino,27020,1862983,32193.0,1122437,12000.0,132291
2021-04-10 15:00:00,Not Hispanic or Latino,18488,1881471,19749.0,1142186,5908.0,138199
2021-04-11 15:00:00,Not Hispanic or Latino,13085,1894556,10343.0,1152529,8528.0,146727
2021-04-12 15:00:00,Not Hispanic or Latino,19420,1913976,28262.0,1180791,8939.0,155666
2021-04-13 15:00:00,Not Hispanic or Latino,35282,1949258,31232.0,1212023,274.0,155940
2021-04-14 15:00:00,Not Hispanic or Latino,32265,1981523,32203.0,1244226,154.0,156094
2021-04-15 15:00:00,Not Hispanic or Latino,32910,2014433,32844.0,1277070,108.0,156202
2021-04-16 15:00:00,Not Hispanic or Latino,28766,2043199,31739.0,1308809,9.0,156211
2021-04-17 15:00:00,Not Hispanic or Latino,24002,2067201,16851.0,1325660,4.0,156215
2021-04-18 15:00:00,Not Hispanic or Latino,14099,2081300,12881.0,1338541,3.0,156218
2021-04-19 15:00:00,Not Hispanic or Latino,21742,2103042,29158.0,1367699,45.0,156263
2021-04-20 15:00:00,Not Hispanic or Latino,22578,2125620,35282.0,1402981,32.0,156295
2021-04-21 15:00:00,Not Hispanic or Latino,28061,2153681,36008.0,1438989,14.0,156309
2021-04-22 15:00:00,Not Hispanic or Latino,27615,2181296,34135.0,1473124,15.0,156324
2021-04-23 15:00:00,Not Hispanic or Latino,23500,2204796,32590.0,1505714,10.0,156334
2021-04-24 15:00:00,Not Hispanic or Latino,18456,2223252,23279.0,1528993,61.0,156395
2021-04-25 15:00:00,Not Hispanic or Latino,13675,2236927,6585.0,1535578,21.0,156416
2021-04-26 15:00:00,Not Hispanic or Latino,17662,2254589,24508.0,1560086,177.0,156593
2021-04-27 15:00:00,Not Hispanic or Latino,18039,2272628,25996.0,1586082,740.0,157333
2021-04-28 15:00:00,Not Hispanic or Latino,21572,2294200,30991.0,1617073,1064.0,158397
2021-04-29 15:00:00,Not Hispanic or Latino,20274,2314474,30693.0,1647766,1186.0,159583
2021-04-30 15:00:00,Not Hispanic or Latino,20671,2335145,25003.0,1672769,1309.0,160892
2021-05-01 15:00:00,Not Hispanic or Latino,12576,2347721,17443.0,1690212,730.0,161622
2021-05-02 15:00:00,Not Hispanic or Latino,6188,2353909,10970.0,1701182,623.0,162245
2021-05-03 15:00:00,Not Hispanic or Latino,9766,2363675,21024.0,1722206,1538.0,163783
2021-05-04 15:00:00,Not Hispanic or Latino,10618,2374293,30882.0,1753088,1429.0,165212
2021-05-05 15:00:00,Not Hispanic or Latino,13586,2387879,28121.0,1781209,1554.0,166766
2021-05-06 15:00:00,Not Hispanic or Latino,12974,2400853,30654.0,1811863,1413.0,168179
2021-05-07 15:00:00,Not Hispanic or Latino,12271,2413124,26704.0,1838567,1601.0,169780
2021-05-08 15:00:00,Not Hispanic or Latino,6999,2420123,21828.0,1860395,988.0,170768
2021-05-09 15:00:00,Not Hispanic or Latino,3453,2423576,8062.0,1868457,553.0,171321
2021-05-10 15:00:00,Not Hispanic or Latino,6353,2429929,22180.0,1890637,1029.0,172350
2021-05-11 15:00:00,Not Hispanic or Latino,8496,2438425,22392.0,1913029,1060.0,173410
2021-05-12 15:00:00,Not Hispanic or Latino,7032,2445457,24051.0,1937080,1095.0,174505
2021-05-13 15:00:00,Not Hispanic or Latino,8822,2454279,16123.0,1953203,551.0,175056
