VACCINATION_DATE,Ethnicity,FirstDoseDaily,FirstDoseCumulative,SecondDoseDaily,SecondDoseCumulative,SingleDoseDaily,SingleDoseCumulative
2020-12-14 15:00:00,Unknown,1,1,,0,,0
2020-12-16 15:00:00,Unknown,10,11,,0,,0
2020-12-17 15:00:00,Unknown,17,28,,0,,0
2020-12-18 15:00:00,Unknown,90,118,,0,,0
2020-12-19 15:00:00,Unknown,27,145,,0,,0
2020-12-20 15:00:00,Unknown,29,174,,0,,0
2020-12-21 15:00:00,Unknown,69,243,,0,,0
2020-12-22 15:00:00,Unknown,400,643,,0,,0
2020-12-23 15:00:00,Unknown,187,830,,0,,0
2020-12-24 15:00:00,Unknown,60,890,,0,,0
2020-12-25 15:00:00,Unknown,180,1070,,0,,0
2020-12-26 15:00:00,Unknown,199,1269,,0,,0
2020-12-27 15:00:00,Unknown,143,1412,,0,,0
2020-12-28 15:00:00,Unknown,272,1684,,0,,0
2020-12-29 15:00:00,Unknown,459,2143,,0,,0
2020-12-30 15:00:00,Unknown,366,2509,,0,,0
2020-12-31 15:00:00,Unknown,216,2725,,0,,0
2021-01-01 15:00:00,Unknown,149,2874,2.0,2,,0
2021-01-02 15:00:00,Unknown,164,3038,2.0,4,,0
2021-01-03 15:00:00,Unknown,229,3267,4.0,8,,0
2021-01-04 15:00:00,Unknown,588,3855,6.0,14,,0
2021-01-05 15:00:00,Unknown,509,4364,18.0,32,,0
2021-01-06 15:00:00,Unknown,653,5017,22.0,54,,0
2021-01-07 15:00:00,Unknown,415,5432,55.0,109,,0
2021-01-08 15:00:00,Unknown,8304,13736,71.0,180,,0
2021-01-09 15:00:00,Unknown,222,13958,39.0,219,,0
2021-01-10 15:00:00,Unknown,179,14137,9.0,228,,0
2021-01-11 15:00:00,Unknown,328,14465,75.0,303,,0
2021-01-12 15:00:00,Unknown,703,15168,334.0,637,,0
2021-01-13 15:00:00,Unknown,406,15574,129.0,766,,0
2021-01-14 15:00:00,Unknown,388,15962,60.0,826,,0
2021-01-15 15:00:00,Unknown,531,16493,179.0,1005,,0
2021-01-16 15:00:00,Unknown,289,16782,159.0,1164,,0
2021-01-17 15:00:00,Unknown,110,16892,97.0,1261,,0
2021-01-18 15:00:00,Unknown,177,17069,198.0,1459,,0
2021-01-19 15:00:00,Unknown,298,17367,250.0,1709,,0
2021-01-20 15:00:00,Unknown,370,17737,166.0,1875,,0
2021-01-21 15:00:00,Unknown,461,18198,94.0,1969,,0
2021-01-22 15:00:00,Unknown,699,18897,166.0,2135,,0
2021-01-23 15:00:00,Unknown,419,19316,143.0,2278,,0
2021-01-24 15:00:00,Unknown,198,19514,150.0,2428,,0
2021-01-25 15:00:00,Unknown,548,20062,463.0,2891,,0
2021-01-26 15:00:00,Unknown,631,20693,369.0,3260,,0
2021-01-27 15:00:00,Unknown,500,21193,532.0,3792,,0
2021-01-28 15:00:00,Unknown,474,21667,270.0,4062,,0
2021-01-29 15:00:00,Unknown,504,22171,201.0,4263,,0
2021-01-30 15:00:00,Unknown,291,22462,48.0,4311,,0
2021-01-31 15:00:00,Unknown,344,22806,82.0,4393,,0
2021-02-01 15:00:00,Unknown,426,23232,196.0,4589,,0
2021-02-02 15:00:00,Unknown,574,23806,637.0,5226,,0
2021-02-03 15:00:00,Unknown,697,24503,469.0,5695,,0
2021-02-04 15:00:00,Unknown,836,25339,409.0,6104,,0
2021-02-05 15:00:00,Unknown,661,26000,414.0,6518,,0
2021-02-06 15:00:00,Unknown,384,26384,8205.0,14723,,0
2021-02-07 15:00:00,Unknown,375,26759,91.0,14814,,0
2021-04-13 15:00:00,Federal Entities,84295,84295,54201.0,54201,2952.0,2952
2021-04-14 15:00:00,Federal Entities,557,84852,11.0,54212,1.0,2953
2021-04-15 15:00:00,Federal Entities,623,85475,823.0,55035,19.0,2972
2021-04-16 15:00:00,Federal Entities,782,86257,1016.0,56051,8.0,2980
2021-04-17 15:00:00,Federal Entities,1136,87393,1177.0,57228,6.0,2986
2021-04-19 15:00:00,Federal Entities,1369,88762,2003.0,59231,9.0,2995
2021-04-20 15:00:00,Federal Entities,3243,92005,2158.0,61389,19.0,3014
2021-04-21 15:00:00,Federal Entities,906,92911,1206.0,62595,4.0,3018
2021-04-22 15:00:00,Federal Entities,1018,93929,458.0,63053,,3018
2021-04-23 15:00:00,Federal Entities,759,94688,632.0,63685,1.0,3019
2021-04-25 15:00:00,Federal Entities,992,95680,2492.0,66177,5.0,3024
2021-04-26 15:00:00,Federal Entities,1483,97163,1672.0,67849,1.0,3025
2021-04-29 15:00:00,Federal Entities,223,97386,865.0,68714,2.0,3027
2021-05-01 15:00:00,Federal Entities,1556,98942,1974.0,70688,14.0,3041
2021-05-02 15:00:00,Federal Entities,1071,100013,1875.0,72563,4.0,3045
2021-05-03 15:00:00,Federal Entities,403,100416,2165.0,74728,4.0,3049
2021-05-04 15:00:00,Federal Entities,28,100444,25.0,74753,,3049
2021-05-05 15:00:00,Federal Entities,365,100809,814.0,75567,,3049
2021-05-06 15:00:00,Federal Entities,275,101084,880.0,76447,3.0,3052
2021-05-07 15:00:00,Federal Entities,274,101358,966.0,77413,8.0,3060
2021-05-08 15:00:00,Federal Entities,297,101655,1312.0,78725,6.0,3066
2021-05-10 15:00:00,Federal Entities,338,101993,1712.0,80437,1.0,3067
2021-05-11 15:00:00,Federal Entities,18,102011,13.0,80450,,3067
2021-05-12 15:00:00,Federal Entities,243,102254,1124.0,81574,,3067
2021-05-14 15:00:00,Federal Entities,290,102544,1022.0,82596,2.0,3069
2021-05-15 15:00:00,Federal Entities,611,103155,1701.0,84297,4.0,3073
2021-05-17 15:00:00,Federal Entities,565,103720,2505.0,86802,11.0,3084
2021-05-18 15:00:00,Federal Entities,164,103884,61.0,86863,2.0,3086
2021-05-20 15:00:00,Federal Entities,885,104769,1024.0,87887,,3086
2021-05-22 15:00:00,Federal Entities,911,105680,1359.0,89246,9.0,3095
2021-05-24 15:00:00,Federal Entities,514,106194,1032.0,90278,8.0,3103
2021-05-25 15:00:00,Federal Entities,5,106199,1.0,90279,2.0,3105
2021-05-27 15:00:00,Federal Entities,425,106624,674.0,90953,1.0,3106
2021-05-28 15:00:00,Federal Entities,418,107042,342.0,91295,,3106
2021-05-29 15:00:00,Federal Entities,267,107309,344.0,91639,10.0,3116
2021-05-31 15:00:00,Federal Entities,214,107523,243.0,91882,3.0,3119
2021-06-01 15:00:00,Federal Entities,30,107553,48.0,91930,,3119
2020-12-15 15:00:00,Hispanic or Latino,3,3,,0,,0
2020-12-16 15:00:00,Hispanic or Latino,18,21,,0,,0
2020-12-17 15:00:00,Hispanic or Latino,37,58,,0,,0
2020-12-18 15:00:00,Hispanic or Latino,85,143,,0,,0
2020-12-19 15:00:00,Hispanic or Latino,37,180,,0,,0
2020-12-20 15:00:00,Hispanic or Latino,10,190,,0,,0
2020-12-21 15:00:00,Hispanic or Latino,148,338,1.0,1,,0
2020-12-22 15:00:00,Hispanic or Latino,256,594,,1,,0
2020-12-23 15:00:00,Hispanic or Latino,185,779,1.0,2,,0
2020-12-24 15:00:00,Hispanic or Latino,90,869,,2,,0
2020-12-25 15:00:00,Hispanic or Latino,40,909,,2,,0
2020-12-26 15:00:00,Hispanic or Latino,38,947,,2,,0
2020-12-27 15:00:00,Hispanic or Latino,59,1006,,2,,0
2020-12-28 15:00:00,Hispanic or Latino,259,1265,1.0,3,,0
2020-12-29 15:00:00,Hispanic or Latino,360,1625,2.0,5,,0
2020-12-30 15:00:00,Hispanic or Latino,503,2128,2.0,7,,0
2020-12-31 15:00:00,Hispanic or Latino,326,2454,2.0,9,,0
2021-01-01 15:00:00,Hispanic or Latino,54,2508,6.0,15,,0
2021-01-02 15:00:00,Hispanic or Latino,83,2591,2.0,17,,0
2021-01-03 15:00:00,Hispanic or Latino,116,2707,3.0,20,,0
2021-01-04 15:00:00,Hispanic or Latino,613,3320,12.0,32,,0
2021-02-08 15:00:00,Unknown,684,27443,251.0,15065,,0
2021-02-09 15:00:00,Unknown,728,28171,299.0,15364,,0
2021-02-10 15:00:00,Unknown,786,28957,419.0,15783,,0
2021-02-11 15:00:00,Unknown,868,29825,403.0,16186,,0
2021-02-12 15:00:00,Unknown,741,30566,546.0,16732,,0
2021-02-13 15:00:00,Unknown,404,30970,157.0,16889,,0
2021-02-14 15:00:00,Unknown,440,31410,122.0,17011,,0
2021-02-15 15:00:00,Unknown,450,31860,524.0,17535,,0
2021-02-16 15:00:00,Unknown,705,32565,669.0,18204,,0
2021-02-17 15:00:00,Unknown,795,33360,471.0,18675,,0
2021-02-18 15:00:00,Unknown,260,33620,247.0,18922,,0
2021-02-19 15:00:00,Unknown,557,34177,456.0,19378,,0
2021-02-20 15:00:00,Unknown,588,34765,393.0,19771,,0
2021-02-21 15:00:00,Unknown,344,35109,323.0,20094,,0
2021-02-22 15:00:00,Unknown,427,35536,412.0,20506,,0
2021-02-23 15:00:00,Unknown,633,36169,393.0,20899,,0
2021-02-24 15:00:00,Unknown,606,36775,497.0,21396,,0
2021-02-25 15:00:00,Unknown,602,37377,804.0,22200,,0
2021-02-26 15:00:00,Unknown,744,38121,761.0,22961,,0
2021-02-27 15:00:00,Unknown,553,38674,295.0,23256,,0
2021-02-28 15:00:00,Unknown,631,39305,205.0,23461,,0
2021-03-01 15:00:00,Unknown,823,40128,478.0,23939,,0
2021-03-02 15:00:00,Unknown,762,40890,526.0,24465,1.0,1
2021-03-03 15:00:00,Unknown,954,41844,583.0,25048,3.0,4
2021-03-04 15:00:00,Unknown,932,42776,676.0,25724,103.0,107
2021-03-05 15:00:00,Unknown,965,43741,556.0,26280,87.0,194
2021-03-06 15:00:00,Unknown,644,44385,299.0,26579,189.0,383
2021-03-07 15:00:00,Unknown,518,44903,331.0,26910,296.0,679
2021-03-08 15:00:00,Unknown,893,45796,344.0,27254,357.0,1036
2021-03-09 15:00:00,Unknown,866,46662,448.0,27702,370.0,1406
2021-03-10 15:00:00,Unknown,793,47455,482.0,28184,491.0,1897
2021-03-11 15:00:00,Unknown,951,48406,509.0,28693,190.0,2087
2021-03-12 15:00:00,Unknown,1170,49576,608.0,29301,162.0,2249
2021-03-13 15:00:00,Unknown,845,50421,370.0,29671,75.0,2324
2021-03-14 15:00:00,Unknown,1022,51443,351.0,30022,69.0,2393
2021-03-15 15:00:00,Unknown,1619,53062,400.0,30422,36.0,2429
2021-03-16 15:00:00,Unknown,1579,54641,585.0,31007,45.0,2474
2021-03-17 15:00:00,Unknown,1590,56231,670.0,31677,63.0,2537
2021-03-18 15:00:00,Unknown,1749,57980,447.0,32124,58.0,2595
2021-03-19 15:00:00,Unknown,1438,59418,424.0,32548,56.0,2651
2021-03-20 15:00:00,Unknown,1273,60691,435.0,32983,37.0,2688
2021-03-21 15:00:00,Unknown,1090,61781,474.0,33457,24.0,2712
2021-03-22 15:00:00,Unknown,1545,63326,488.0,33945,32.0,2744
2021-03-23 15:00:00,Unknown,1965,65291,601.0,34546,75.0,2819
2021-03-24 15:00:00,Unknown,2567,67858,524.0,35070,74.0,2893
2021-03-25 15:00:00,Unknown,2589,70447,588.0,35658,323.0,3216
2021-03-26 15:00:00,Unknown,2554,73001,670.0,36328,356.0,3572
2021-03-27 15:00:00,Unknown,1845,74846,507.0,36835,398.0,3970
2021-03-28 15:00:00,Unknown,1893,76739,499.0,37334,420.0,4390
2021-03-29 15:00:00,Unknown,2638,79377,937.0,38271,75.0,4465
2021-03-30 15:00:00,Unknown,2493,81870,977.0,39248,124.0,4589
2021-03-31 15:00:00,Unknown,2480,84350,843.0,40091,797.0,5386
2021-04-01 15:00:00,Unknown,1806,86156,973.0,41064,623.0,6009
2021-04-02 15:00:00,Unknown,1856,88012,1261.0,42325,742.0,6751
2021-04-03 15:00:00,Unknown,1644,89656,835.0,43160,662.0,7413
2021-04-04 15:00:00,Unknown,602,90258,649.0,43809,48.0,7461
2021-04-05 15:00:00,Unknown,1841,92099,1102.0,44911,664.0,8125
2021-04-06 15:00:00,Unknown,2181,94280,1241.0,46152,876.0,9001
2021-04-07 15:00:00,Unknown,2424,96704,1327.0,47479,1325.0,10326
2021-04-08 15:00:00,Unknown,3040,99744,1493.0,48972,1493.0,11819
2021-04-09 15:00:00,Unknown,3270,103014,1059.0,50031,1272.0,13091
2021-04-10 15:00:00,Unknown,2761,105775,1051.0,51082,979.0,14070
2021-04-11 15:00:00,Unknown,2472,108247,1065.0,52147,851.0,14921
2021-04-12 15:00:00,Unknown,2776,111023,1848.0,53995,1070.0,15991
2021-04-13 15:00:00,Unknown,3258,114281,1886.0,55881,33.0,16024
2021-04-14 15:00:00,Unknown,3122,117403,2132.0,58013,10.0,16034
2021-04-15 15:00:00,Unknown,3749,121152,2290.0,60303,14.0,16048
2021-04-16 15:00:00,Unknown,3355,124507,2350.0,62653,2.0,16050
2021-04-17 15:00:00,Unknown,3670,128177,1634.0,64287,1.0,16051
2021-04-18 15:00:00,Unknown,2911,131088,1678.0,65965,,16051
2021-04-19 15:00:00,Unknown,2766,133854,2402.0,68367,3.0,16054
2021-04-20 15:00:00,Unknown,2258,136112,2159.0,70526,,16054
2021-04-21 15:00:00,Unknown,3024,139136,2485.0,73011,,16054
2021-04-22 15:00:00,Unknown,2715,141851,1280.0,74291,,16054
2021-04-23 15:00:00,Unknown,3178,145029,1960.0,76251,2.0,16056
2021-04-24 15:00:00,Unknown,3089,148118,1529.0,77780,3.0,16059
2021-04-25 15:00:00,Unknown,2380,150498,763.0,78543,,16059
2021-04-26 15:00:00,Unknown,1761,152259,1516.0,80059,11.0,16070
2021-04-27 15:00:00,Unknown,2310,154569,1445.0,81504,81.0,16151
2021-04-28 15:00:00,Unknown,2068,156637,2558.0,84062,94.0,16245
2021-04-29 15:00:00,Unknown,1830,158467,2681.0,86743,81.0,16326
2021-04-30 15:00:00,Unknown,1956,160423,2746.0,89489,110.0,16436
2021-05-01 15:00:00,Unknown,1571,161994,2578.0,92067,56.0,16492
2021-05-02 15:00:00,Unknown,1213,163207,2228.0,94295,34.0,16526
2021-05-03 15:00:00,Unknown,764,163971,2746.0,97041,87.0,16613
2021-05-04 15:00:00,Unknown,764,164735,3001.0,100042,102.0,16715
2021-05-05 15:00:00,Unknown,1405,166140,2929.0,102971,115.0,16830
2021-05-06 15:00:00,Unknown,1204,167344,3283.0,106254,93.0,16923
2021-05-07 15:00:00,Unknown,1237,168581,2839.0,109093,105.0,17028
2021-05-08 15:00:00,Unknown,1011,169592,3169.0,112262,106.0,17134
2021-05-09 15:00:00,Unknown,692,170284,1533.0,113795,35.0,17169
2021-05-10 15:00:00,Unknown,621,170905,2870.0,116665,82.0,17251
2021-05-11 15:00:00,Unknown,736,171641,2322.0,118987,81.0,17332
2021-05-12 15:00:00,Unknown,890,172531,2734.0,121721,156.0,17488
2021-05-13 15:00:00,Unknown,1071,173602,2335.0,124056,140.0,17628
2021-05-14 15:00:00,Unknown,1224,174826,2366.0,126422,186.0,17814
2021-05-15 15:00:00,Unknown,1443,176269,2467.0,128889,233.0,18047
2021-05-16 15:00:00,Unknown,575,176844,2124.0,131013,199.0,18246
2021-05-17 15:00:00,Unknown,660,177504,1729.0,132742,225.0,18471
2021-05-18 15:00:00,Unknown,1091,178595,2564.0,135306,189.0,18660
2021-05-19 15:00:00,Unknown,1353,179948,2504.0,137810,167.0,18827
2021-05-20 15:00:00,Unknown,1170,181118,2110.0,139920,171.0,18998
2021-05-21 15:00:00,Unknown,1262,182380,2073.0,141993,195.0,19193
2021-05-22 15:00:00,Unknown,1302,183682,1216.0,143209,228.0,19421
2021-05-23 15:00:00,Unknown,768,184450,1271.0,144480,191.0,19612
2021-05-24 15:00:00,Unknown,776,185226,820.0,145300,220.0,19832
2021-01-05 15:00:00,Hispanic or Latino,405,3725,19.0,51,,0
2021-01-06 15:00:00,Hispanic or Latino,579,4304,19.0,70,,0
2021-01-07 15:00:00,Hispanic or Latino,801,5105,61.0,131,,0
2021-01-08 15:00:00,Hispanic or Latino,871,5976,92.0,223,,0
2021-01-09 15:00:00,Hispanic or Latino,194,6170,33.0,256,,0
2021-01-10 15:00:00,Hispanic or Latino,138,6308,21.0,277,,0
2021-01-11 15:00:00,Hispanic or Latino,546,6854,130.0,407,,0
2021-01-12 15:00:00,Hispanic or Latino,736,7590,206.0,613,,0
2021-01-13 15:00:00,Hispanic or Latino,676,8266,132.0,745,,0
2021-01-14 15:00:00,Hispanic or Latino,741,9007,67.0,812,,0
2021-01-15 15:00:00,Hispanic or Latino,875,9882,67.0,879,,0
2021-01-16 15:00:00,Hispanic or Latino,180,10062,42.0,921,,0
2021-01-17 15:00:00,Hispanic or Latino,99,10161,41.0,962,,0
2021-01-18 15:00:00,Hispanic or Latino,171,10332,108.0,1070,,0
2021-01-19 15:00:00,Hispanic or Latino,472,10804,159.0,1229,,0
2021-01-20 15:00:00,Hispanic or Latino,628,11432,182.0,1411,,0
2021-01-21 15:00:00,Hispanic or Latino,757,12189,124.0,1535,,0
2021-01-22 15:00:00,Hispanic or Latino,961,13150,106.0,1641,,0
2021-01-23 15:00:00,Hispanic or Latino,331,13481,54.0,1695,,0
2021-01-24 15:00:00,Hispanic or Latino,98,13579,37.0,1732,,0
2021-01-25 15:00:00,Hispanic or Latino,375,13954,302.0,2034,,0
2021-01-26 15:00:00,Hispanic or Latino,497,14451,225.0,2259,,0
2021-01-27 15:00:00,Hispanic or Latino,744,15195,436.0,2695,,0
2021-01-28 15:00:00,Hispanic or Latino,791,15986,391.0,3086,,0
2021-01-29 15:00:00,Hispanic or Latino,709,16695,295.0,3381,,0
2021-01-30 15:00:00,Hispanic or Latino,502,17197,91.0,3472,,0
2021-01-31 15:00:00,Hispanic or Latino,132,17329,29.0,3501,,0
2021-02-01 15:00:00,Hispanic or Latino,171,17500,150.0,3651,,0
2021-02-02 15:00:00,Hispanic or Latino,419,17919,593.0,4244,,0
2021-02-03 15:00:00,Hispanic or Latino,603,18522,662.0,4906,,0
2021-02-04 15:00:00,Hispanic or Latino,740,19262,717.0,5623,,0
2021-02-05 15:00:00,Hispanic or Latino,759,20021,867.0,6490,,0
2021-02-06 15:00:00,Hispanic or Latino,387,20408,204.0,6694,,0
2021-02-07 15:00:00,Hispanic or Latino,165,20573,64.0,6758,,0
2021-02-08 15:00:00,Hispanic or Latino,531,21104,605.0,7363,,0
2021-02-09 15:00:00,Hispanic or Latino,546,21650,513.0,7876,,0
2021-02-10 15:00:00,Hispanic or Latino,702,22352,691.0,8567,,0
2021-02-11 15:00:00,Hispanic or Latino,855,23207,717.0,9284,,0
2021-02-12 15:00:00,Hispanic or Latino,778,23985,850.0,10134,,0
2021-02-13 15:00:00,Hispanic or Latino,362,24347,219.0,10353,,0
2021-02-14 15:00:00,Hispanic or Latino,277,24624,65.0,10418,,0
2021-02-15 15:00:00,Hispanic or Latino,315,24939,363.0,10781,,0
2021-02-16 15:00:00,Hispanic or Latino,511,25450,537.0,11318,,0
2021-02-17 15:00:00,Hispanic or Latino,696,26146,740.0,12058,,0
2021-02-18 15:00:00,Hispanic or Latino,116,26262,132.0,12190,,0
2021-02-19 15:00:00,Hispanic or Latino,371,26633,748.0,12938,,0
2021-02-20 15:00:00,Hispanic or Latino,370,27003,630.0,13568,,0
2021-02-21 15:00:00,Hispanic or Latino,311,27314,243.0,13811,,0
2021-02-22 15:00:00,Hispanic or Latino,292,27606,418.0,14229,,0
2021-02-23 15:00:00,Hispanic or Latino,527,28133,484.0,14713,,0
2021-02-24 15:00:00,Hispanic or Latino,567,28700,812.0,15525,,0
2021-02-25 15:00:00,Hispanic or Latino,776,29476,814.0,16339,,0
2021-02-26 15:00:00,Hispanic or Latino,1125,30601,834.0,17173,,0
2021-02-27 15:00:00,Hispanic or Latino,671,31272,342.0,17515,,0
2021-02-28 15:00:00,Hispanic or Latino,731,32003,179.0,17694,,0
2021-03-01 15:00:00,Hispanic or Latino,1124,33127,419.0,18113,,0
2021-03-02 15:00:00,Hispanic or Latino,1050,34177,350.0,18463,1.0,1
2021-03-03 15:00:00,Hispanic or Latino,1157,35334,655.0,19118,13.0,14
2021-03-04 15:00:00,Hispanic or Latino,1352,36686,497.0,19615,149.0,163
2021-03-05 15:00:00,Hispanic or Latino,1656,38342,604.0,20219,202.0,365
2021-03-06 15:00:00,Hispanic or Latino,904,39246,275.0,20494,384.0,749
2021-03-07 15:00:00,Hispanic or Latino,581,39827,196.0,20690,287.0,1036
2021-03-08 15:00:00,Hispanic or Latino,1202,41029,305.0,20995,364.0,1400
2021-05-25 15:00:00,Unknown,897,186123,827.0,146127,135.0,19967
2021-05-26 15:00:00,Unknown,1049,187172,1099.0,147226,180.0,20147
2021-05-27 15:00:00,Unknown,780,187952,975.0,148201,125.0,20272
2021-05-28 15:00:00,Unknown,831,188783,1221.0,149422,177.0,20449
2021-05-29 15:00:00,Unknown,866,189649,1230.0,150652,227.0,20676
2021-05-30 15:00:00,Unknown,455,190104,860.0,151512,136.0,20812
2021-05-31 15:00:00,Unknown,96,190200,201.0,151713,72.0,20884
2021-06-01 15:00:00,Unknown,702,190902,899.0,152612,130.0,21014
2021-06-02 15:00:00,Unknown,673,191575,995.0,153607,77.0,21091
2021-06-03 15:00:00,Unknown,537,192112,977.0,154584,90.0,21181
2021-06-04 15:00:00,Unknown,583,192695,1091.0,155675,65.0,21246
2021-06-05 15:00:00,Unknown,620,193315,1153.0,156828,43.0,21289
2021-06-06 15:00:00,Unknown,269,193584,463.0,157291,54.0,21343
2021-06-07 15:00:00,Unknown,451,194035,417.0,157708,48.0,21391
2021-06-08 15:00:00,Unknown,497,194532,734.0,158442,78.0,21469
2021-06-09 15:00:00,Unknown,394,194926,765.0,159207,45.0,21514
2021-06-10 15:00:00,Unknown,350,195276,711.0,159918,46.0,21560
2021-06-11 15:00:00,Unknown,278,195554,590.0,160508,71.0,21631
2021-06-12 15:00:00,Unknown,414,195968,872.0,161380,54.0,21685
2021-06-13 15:00:00,Unknown,180,196148,338.0,161718,23.0,21708
2020-12-14 15:00:00,Not Hispanic or Latino,5,5,,0,,0
2020-12-15 15:00:00,Not Hispanic or Latino,16,21,1.0,1,,0
2020-12-16 15:00:00,Not Hispanic or Latino,523,544,2.0,3,,0
2020-12-17 15:00:00,Not Hispanic or Latino,1013,1557,,3,,0
2020-12-18 15:00:00,Not Hispanic or Latino,2701,4258,2.0,5,,0
2020-12-19 15:00:00,Not Hispanic or Latino,794,5052,1.0,6,,0
2020-12-20 15:00:00,Not Hispanic or Latino,248,5300,3.0,9,,0
2020-12-21 15:00:00,Not Hispanic or Latino,3519,8819,3.0,12,,0
2020-12-22 15:00:00,Not Hispanic or Latino,5541,14360,4.0,16,,0
2020-12-23 15:00:00,Not Hispanic or Latino,5129,19489,13.0,29,,0
2020-12-24 15:00:00,Not Hispanic or Latino,2499,21988,5.0,34,,0
2020-12-25 15:00:00,Not Hispanic or Latino,811,22799,2.0,36,,0
2020-12-26 15:00:00,Not Hispanic or Latino,1436,24235,3.0,39,,0
2020-12-27 15:00:00,Not Hispanic or Latino,1569,25804,5.0,44,,0
2020-12-28 15:00:00,Not Hispanic or Latino,8097,33901,15.0,59,,0
2020-12-29 15:00:00,Not Hispanic or Latino,9694,43595,9.0,68,,0
2020-12-30 15:00:00,Not Hispanic or Latino,11412,55007,22.0,90,,0
2020-12-31 15:00:00,Not Hispanic or Latino,6861,61868,11.0,101,,0
2021-01-01 15:00:00,Not Hispanic or Latino,1571,63439,38.0,139,,0
2021-01-02 15:00:00,Not Hispanic or Latino,2452,65891,23.0,162,,0
2021-01-03 15:00:00,Not Hispanic or Latino,2849,68740,63.0,225,,0
2021-01-04 15:00:00,Not Hispanic or Latino,11719,80459,248.0,473,,0
2021-01-05 15:00:00,Not Hispanic or Latino,11067,91526,413.0,886,,0
2021-01-06 15:00:00,Not Hispanic or Latino,13527,105053,740.0,1626,,0
2021-01-07 15:00:00,Not Hispanic or Latino,13463,118516,1489.0,3115,,0
2021-01-08 15:00:00,Not Hispanic or Latino,14528,133044,2419.0,5534,,0
2021-01-09 15:00:00,Not Hispanic or Latino,4567,137611,803.0,6337,,0
2021-01-10 15:00:00,Not Hispanic or Latino,2461,140072,312.0,6649,,0
2021-01-11 15:00:00,Not Hispanic or Latino,12598,152670,3068.0,9717,,0
2021-01-12 15:00:00,Not Hispanic or Latino,15597,168267,4818.0,14535,,0
2021-01-13 15:00:00,Not Hispanic or Latino,17164,185431,3457.0,17992,,0
2021-01-14 15:00:00,Not Hispanic or Latino,16349,201780,1716.0,19708,,0
2021-01-15 15:00:00,Not Hispanic or Latino,17615,219395,1589.0,21297,,0
2021-01-16 15:00:00,Not Hispanic or Latino,5060,224455,1330.0,22627,,0
2021-01-17 15:00:00,Not Hispanic or Latino,1912,226367,1185.0,23812,,0
2021-01-18 15:00:00,Not Hispanic or Latino,6800,233167,2590.0,26402,,0
2021-01-19 15:00:00,Not Hispanic or Latino,15935,249102,4572.0,30974,,0
2021-03-09 15:00:00,Hispanic or Latino,1230,42259,471.0,21466,442.0,1842
2021-03-10 15:00:00,Hispanic or Latino,1378,43637,615.0,22081,530.0,2372
2021-03-11 15:00:00,Hispanic or Latino,1529,45166,660.0,22741,252.0,2624
2021-03-12 15:00:00,Hispanic or Latino,2076,47242,663.0,23404,221.0,2845
2021-03-13 15:00:00,Hispanic or Latino,1210,48452,385.0,23789,213.0,3058
2021-03-14 15:00:00,Hispanic or Latino,1539,49991,217.0,24006,109.0,3167
2021-03-15 15:00:00,Hispanic or Latino,1778,51769,337.0,24343,42.0,3209
2021-03-16 15:00:00,Hispanic or Latino,2049,53818,422.0,24765,21.0,3230
2021-03-17 15:00:00,Hispanic or Latino,2487,56305,596.0,25361,59.0,3289
2021-03-18 15:00:00,Hispanic or Latino,2609,58914,393.0,25754,96.0,3385
2021-03-19 15:00:00,Hispanic or Latino,2609,61523,529.0,26283,81.0,3466
2021-03-20 15:00:00,Hispanic or Latino,2129,63652,419.0,26702,46.0,3512
2021-03-21 15:00:00,Hispanic or Latino,1620,65272,449.0,27151,15.0,3527
2021-03-22 15:00:00,Hispanic or Latino,2243,67515,439.0,27590,32.0,3559
2021-03-23 15:00:00,Hispanic or Latino,2656,70171,614.0,28204,131.0,3690
2021-03-24 15:00:00,Hispanic or Latino,3201,73372,820.0,29024,206.0,3896
2021-03-25 15:00:00,Hispanic or Latino,3349,76721,845.0,29869,114.0,4010
2021-03-26 15:00:00,Hispanic or Latino,2515,79236,1246.0,31115,196.0,4206
2021-03-27 15:00:00,Hispanic or Latino,2228,81464,806.0,31921,139.0,4345
2021-03-28 15:00:00,Hispanic or Latino,1112,82576,546.0,32467,70.0,4415
2021-03-29 15:00:00,Hispanic or Latino,2010,84586,1236.0,33703,61.0,4476
2021-03-30 15:00:00,Hispanic or Latino,2742,87328,1188.0,34891,110.0,4586
2021-03-31 15:00:00,Hispanic or Latino,3410,90738,1338.0,36229,387.0,4973
2021-04-01 15:00:00,Hispanic or Latino,2874,93612,1660.0,37889,295.0,5268
2021-04-02 15:00:00,Hispanic or Latino,2748,96360,1893.0,39782,326.0,5594
2021-04-03 15:00:00,Hispanic or Latino,2108,98468,995.0,40777,284.0,5878
2021-04-04 15:00:00,Hispanic or Latino,688,99156,574.0,41351,50.0,5928
2021-04-05 15:00:00,Hispanic or Latino,2298,101454,1510.0,42861,359.0,6287
2021-04-06 15:00:00,Hispanic or Latino,3121,104575,1788.0,44649,516.0,6803
2021-04-07 15:00:00,Hispanic or Latino,3537,108112,1766.0,46415,866.0,7669
2021-04-08 15:00:00,Hispanic or Latino,3338,111450,1906.0,48321,1203.0,8872
2021-04-09 15:00:00,Hispanic or Latino,3240,114690,2195.0,50516,1101.0,9973
2021-04-10 15:00:00,Hispanic or Latino,2216,116906,1563.0,52079,609.0,10582
2021-04-11 15:00:00,Hispanic or Latino,2170,119076,1328.0,53407,648.0,11230
2021-04-12 15:00:00,Hispanic or Latino,2171,121247,2120.0,55527,775.0,12005
2021-04-13 15:00:00,Hispanic or Latino,3633,124880,2517.0,58044,29.0,12034
2021-04-14 15:00:00,Hispanic or Latino,4423,129303,2584.0,60628,34.0,12068
2021-04-15 15:00:00,Hispanic or Latino,3682,132985,2261.0,62889,24.0,12092
2021-04-16 15:00:00,Hispanic or Latino,3703,136688,2795.0,65684,,12092
2021-04-17 15:00:00,Hispanic or Latino,3663,140351,1839.0,67523,,12092
2021-04-18 15:00:00,Hispanic or Latino,2390,142741,1186.0,68709,,12092
2021-04-19 15:00:00,Hispanic or Latino,3381,146122,1908.0,70617,5.0,12097
2021-04-20 15:00:00,Hispanic or Latino,3564,149686,2465.0,73082,,12097
2021-04-21 15:00:00,Hispanic or Latino,5062,154748,3171.0,76253,1.0,12098
2021-04-22 15:00:00,Hispanic or Latino,3935,158683,3188.0,79441,,12098
2021-04-23 15:00:00,Hispanic or Latino,3726,162409,3046.0,82487,,12098
2021-04-24 15:00:00,Hispanic or Latino,4333,166742,2552.0,85039,8.0,12106
2021-04-25 15:00:00,Hispanic or Latino,2888,169630,818.0,85857,3.0,12109
2021-04-26 15:00:00,Hispanic or Latino,3586,173216,2418.0,88275,16.0,12125
2021-04-27 15:00:00,Hispanic or Latino,3542,176758,2576.0,90851,113.0,12238
2021-04-28 15:00:00,Hispanic or Latino,3676,180434,3626.0,94477,142.0,12380
2021-04-29 15:00:00,Hispanic or Latino,3614,184048,3070.0,97547,158.0,12538
2021-04-30 15:00:00,Hispanic or Latino,4151,188199,2714.0,100261,174.0,12712
2021-05-01 15:00:00,Hispanic or Latino,3410,191609,2246.0,102507,130.0,12842
2021-05-02 15:00:00,Hispanic or Latino,1604,193213,1621.0,104128,127.0,12969
2021-05-03 15:00:00,Hispanic or Latino,1941,195154,2185.0,106313,237.0,13206
2021-05-04 15:00:00,Hispanic or Latino,1887,197041,3127.0,109440,176.0,13382
2021-05-05 15:00:00,Hispanic or Latino,2902,199943,3802.0,113242,220.0,13602
2021-05-06 15:00:00,Hispanic or Latino,2177,202120,3423.0,116665,165.0,13767
2021-05-07 15:00:00,Hispanic or Latino,3011,205131,3505.0,120170,190.0,13957
2021-05-08 15:00:00,Hispanic or Latino,2012,207143,3184.0,123354,173.0,14130
2021-01-20 15:00:00,Not Hispanic or Latino,19732,268834,4681.0,35655,,0
2021-01-21 15:00:00,Not Hispanic or Latino,21996,290830,3245.0,38900,,0
2021-01-22 15:00:00,Not Hispanic or Latino,26778,317608,3026.0,41926,,0
2021-01-23 15:00:00,Not Hispanic or Latino,8902,326510,1404.0,43330,,0
2021-01-24 15:00:00,Not Hispanic or Latino,3002,329512,1384.0,44714,,0
2021-01-25 15:00:00,Not Hispanic or Latino,15353,344865,7350.0,52064,,0
2021-01-26 15:00:00,Not Hispanic or Latino,16315,361180,7968.0,60032,,0
2021-01-27 15:00:00,Not Hispanic or Latino,22920,384100,11176.0,71208,,0
2021-01-28 15:00:00,Not Hispanic or Latino,21174,405274,8342.0,79550,,0
2021-01-29 15:00:00,Not Hispanic or Latino,22833,428107,6701.0,86251,,0
2021-01-30 15:00:00,Not Hispanic or Latino,16727,444834,2188.0,88439,,0
2021-01-31 15:00:00,Not Hispanic or Latino,3208,448042,1118.0,89557,,0
2021-02-01 15:00:00,Not Hispanic or Latino,6130,454172,4002.0,93559,,0
2021-02-02 15:00:00,Not Hispanic or Latino,11110,465282,12162.0,105721,,0
2021-02-03 15:00:00,Not Hispanic or Latino,16542,481824,16627.0,122348,,0
2021-02-04 15:00:00,Not Hispanic or Latino,20217,502041,14190.0,136538,,0
2021-02-05 15:00:00,Not Hispanic or Latino,18525,520566,15706.0,152244,,0
2021-02-06 15:00:00,Not Hispanic or Latino,10304,530870,5794.0,158038,,0
2021-02-07 15:00:00,Not Hispanic or Latino,5302,536172,1521.0,159559,,0
2021-02-08 15:00:00,Not Hispanic or Latino,11499,547671,11740.0,171299,,0
2021-02-09 15:00:00,Not Hispanic or Latino,15049,562720,12623.0,183922,,0
2021-02-10 15:00:00,Not Hispanic or Latino,17524,580244,19714.0,203636,,0
2021-02-11 15:00:00,Not Hispanic or Latino,20969,601213,15835.0,219471,,0
2021-02-12 15:00:00,Not Hispanic or Latino,18628,619841,17754.0,237225,,0
2021-02-13 15:00:00,Not Hispanic or Latino,10504,630345,5620.0,242845,,0
2021-02-14 15:00:00,Not Hispanic or Latino,6300,636645,1789.0,244634,,0
2021-02-15 15:00:00,Not Hispanic or Latino,10845,647490,11984.0,256618,,0
2021-02-16 15:00:00,Not Hispanic or Latino,15243,662733,19423.0,276041,,0
2021-02-17 15:00:00,Not Hispanic or Latino,18989,681722,24709.0,300750,,0
2021-02-18 15:00:00,Not Hispanic or Latino,2741,684463,4034.0,304784,,0
2021-02-19 15:00:00,Not Hispanic or Latino,9565,694028,18015.0,322799,,0
2021-02-20 15:00:00,Not Hispanic or Latino,9286,703314,18823.0,341622,,0
2021-02-21 15:00:00,Not Hispanic or Latino,5420,708734,6873.0,348495,,0
2021-02-22 15:00:00,Not Hispanic or Latino,7266,716000,14192.0,362687,,0
2021-02-23 15:00:00,Not Hispanic or Latino,14162,730162,14734.0,377421,,0
2021-02-24 15:00:00,Not Hispanic or Latino,16660,746822,22999.0,400420,,0
2021-02-25 15:00:00,Not Hispanic or Latino,18813,765635,24515.0,424935,,0
2021-02-26 15:00:00,Not Hispanic or Latino,24666,790301,24047.0,448982,,0
2021-02-27 15:00:00,Not Hispanic or Latino,14586,804887,10264.0,459246,,0
2021-02-28 15:00:00,Not Hispanic or Latino,14050,818937,4227.0,463473,,0
2021-03-01 15:00:00,Not Hispanic or Latino,22494,841431,10651.0,474124,,0
2021-03-02 15:00:00,Not Hispanic or Latino,21628,863059,11968.0,486092,22.0,22
2021-03-03 15:00:00,Not Hispanic or Latino,27369,890428,16694.0,502786,135.0,157
2021-03-04 15:00:00,Not Hispanic or Latino,28230,918658,16622.0,519408,3808.0,3965
2021-03-05 15:00:00,Not Hispanic or Latino,25903,944561,17614.0,537022,4569.0,8534
2021-03-06 15:00:00,Not Hispanic or Latino,16039,960600,8120.0,545142,5383.0,13917
2021-03-07 15:00:00,Not Hispanic or Latino,10841,971441,4184.0,549326,5977.0,19894
2021-03-08 15:00:00,Not Hispanic or Latino,23363,994804,7810.0,557136,7470.0,27364
2021-03-09 15:00:00,Not Hispanic or Latino,23605,1018409,14159.0,571295,7443.0,34807
2021-03-10 15:00:00,Not Hispanic or Latino,27134,1045543,14459.0,585754,6891.0,41698
2021-03-11 15:00:00,Not Hispanic or Latino,31181,1076724,14917.0,600671,3496.0,45194
2021-03-12 15:00:00,Not Hispanic or Latino,33268,1109992,16364.0,617035,2501.0,47695
2021-03-13 15:00:00,Not Hispanic or Latino,20382,1130374,9222.0,626257,1279.0,48974
2021-03-14 15:00:00,Not Hispanic or Latino,15136,1145510,5975.0,632232,791.0,49765
2021-03-15 15:00:00,Not Hispanic or Latino,25980,1171490,10166.0,642398,482.0,50247
2021-03-16 15:00:00,Not Hispanic or Latino,29364,1200854,12129.0,654527,694.0,50941
2021-03-17 15:00:00,Not Hispanic or Latino,33037,1233891,15275.0,669802,1023.0,51964
2021-03-18 15:00:00,Not Hispanic or Latino,36542,1270433,11321.0,681123,1184.0,53148
2021-03-19 15:00:00,Not Hispanic or Latino,33551,1303984,13998.0,695121,886.0,54034
2021-05-09 15:00:00,Hispanic or Latino,969,208112,1454.0,124808,103.0,14233
2021-05-10 15:00:00,Hispanic or Latino,1308,209420,3063.0,127871,138.0,14371
2021-05-11 15:00:00,Hispanic or Latino,1804,211224,3019.0,130890,155.0,14526
2021-05-12 15:00:00,Hispanic or Latino,2262,213486,4219.0,135109,337.0,14863
2021-05-13 15:00:00,Hispanic or Latino,2487,215973,3417.0,138526,119.0,14982
2021-05-14 15:00:00,Hispanic or Latino,3311,219284,2918.0,141444,183.0,15165
2021-05-15 15:00:00,Hispanic or Latino,3330,222614,3370.0,144814,232.0,15397
2021-05-16 15:00:00,Hispanic or Latino,1397,224011,2294.0,147108,200.0,15597
2021-05-17 15:00:00,Hispanic or Latino,1942,225953,3092.0,150200,191.0,15788
2021-05-18 15:00:00,Hispanic or Latino,2753,228706,3710.0,153910,229.0,16017
2021-05-19 15:00:00,Hispanic or Latino,4057,232763,3947.0,157857,231.0,16248
2021-05-20 15:00:00,Hispanic or Latino,2956,235719,3803.0,161660,224.0,16472
2021-05-21 15:00:00,Hispanic or Latino,2947,238666,4136.0,165796,222.0,16694
2021-05-22 15:00:00,Hispanic or Latino,3164,241830,3380.0,169176,241.0,16935
2021-05-23 15:00:00,Hispanic or Latino,1721,243551,1949.0,171125,171.0,17106
2021-05-24 15:00:00,Hispanic or Latino,1940,245491,2375.0,173500,175.0,17281
2021-05-25 15:00:00,Hispanic or Latino,2058,247549,2317.0,175817,139.0,17420
2021-05-26 15:00:00,Hispanic or Latino,2683,250232,2735.0,178552,151.0,17571
2021-05-27 15:00:00,Hispanic or Latino,1665,251897,2331.0,180883,115.0,17686
2021-05-28 15:00:00,Hispanic or Latino,2079,253976,3025.0,183908,194.0,17880
2021-05-29 15:00:00,Hispanic or Latino,2373,256349,2191.0,186099,146.0,18026
2021-05-30 15:00:00,Hispanic or Latino,1100,257449,1057.0,187156,103.0,18129
2021-05-31 15:00:00,Hispanic or Latino,291,257740,536.0,187692,43.0,18172
2021-06-01 15:00:00,Hispanic or Latino,1733,259473,2110.0,189802,149.0,18321
2021-06-02 15:00:00,Hispanic or Latino,2012,261485,2074.0,191876,123.0,18444
2021-06-03 15:00:00,Hispanic or Latino,1388,262873,2086.0,193962,121.0,18565
2021-06-04 15:00:00,Hispanic or Latino,1536,264409,3135.0,197097,130.0,18695
2021-06-05 15:00:00,Hispanic or Latino,1551,265960,2417.0,199514,115.0,18810
2021-06-06 15:00:00,Hispanic or Latino,973,266933,836.0,200350,84.0,18894
2021-06-07 15:00:00,Hispanic or Latino,1377,268310,1696.0,202046,98.0,18992
2021-06-08 15:00:00,Hispanic or Latino,1313,269623,2478.0,204524,110.0,19102
2021-06-09 15:00:00,Hispanic or Latino,1529,271152,2899.0,207423,111.0,19213
2021-06-10 15:00:00,Hispanic or Latino,835,271987,2126.0,209549,56.0,19269
2021-06-11 15:00:00,Hispanic or Latino,632,272619,1510.0,211059,107.0,19376
2021-06-12 15:00:00,Hispanic or Latino,685,273304,2136.0,213195,60.0,19436
2021-06-13 15:00:00,Hispanic or Latino,145,273449,484.0,213679,47.0,19483
2021-03-20 15:00:00,Not Hispanic or Latino,20799,1324783,8912.0,704033,593.0,54627
2021-03-21 15:00:00,Not Hispanic or Latino,16147,1340930,6691.0,710724,275.0,54902
2021-03-22 15:00:00,Not Hispanic or Latino,28501,1369431,10098.0,720822,756.0,55658
2021-03-23 15:00:00,Not Hispanic or Latino,32809,1402240,15631.0,736453,1318.0,56976
2021-03-24 15:00:00,Not Hispanic or Latino,34907,1437147,19210.0,755663,1077.0,58053
2021-03-25 15:00:00,Not Hispanic or Latino,36015,1473162,18997.0,774660,2019.0,60072
2021-03-26 15:00:00,Not Hispanic or Latino,31333,1504495,23449.0,798109,1941.0,62013
2021-03-27 15:00:00,Not Hispanic or Latino,22797,1527292,15167.0,813276,1848.0,63861
2021-03-28 15:00:00,Not Hispanic or Latino,13882,1541174,11377.0,824653,1123.0,64984
2021-03-29 15:00:00,Not Hispanic or Latino,24937,1566111,23554.0,848207,989.0,65973
2021-03-30 15:00:00,Not Hispanic or Latino,34371,1600482,26217.0,874424,1600.0,67573
2021-03-31 15:00:00,Not Hispanic or Latino,34733,1635215,31740.0,906164,4547.0,72120
2021-04-01 15:00:00,Not Hispanic or Latino,36126,1671341,34011.0,940175,4546.0,76666
2021-04-02 15:00:00,Not Hispanic or Latino,29874,1701215,28503.0,968678,4720.0,81386
2021-04-03 15:00:00,Not Hispanic or Latino,17703,1718918,16436.0,985114,3453.0,84839
2021-04-04 15:00:00,Not Hispanic or Latino,6969,1725887,8777.0,993891,836.0,85675
2021-04-05 15:00:00,Not Hispanic or Latino,23513,1749400,25686.0,1019577,5587.0,91262
2021-04-06 15:00:00,Not Hispanic or Latino,34293,1783693,26777.0,1046354,9059.0,100321
2021-04-07 15:00:00,Not Hispanic or Latino,29729,1813422,30393.0,1076747,10695.0,111016
2021-04-08 15:00:00,Not Hispanic or Latino,35560,1848982,32064.0,1108811,11094.0,122110
2021-04-09 15:00:00,Not Hispanic or Latino,27180,1876162,32386.0,1141197,12047.0,134157
2021-04-10 15:00:00,Not Hispanic or Latino,18347,1894509,20104.0,1161301,5977.0,140134
2021-04-11 15:00:00,Not Hispanic or Latino,12863,1907372,10747.0,1172048,8574.0,148708
2021-04-12 15:00:00,Not Hispanic or Latino,19576,1926948,28737.0,1200785,9032.0,157740
2021-04-13 15:00:00,Not Hispanic or Latino,35474,1962422,31460.0,1232245,278.0,158018
2021-04-14 15:00:00,Not Hispanic or Latino,32395,1994817,32411.0,1264656,157.0,158175
2021-04-15 15:00:00,Not Hispanic or Latino,33279,2028096,33028.0,1297684,110.0,158285
2021-04-16 15:00:00,Not Hispanic or Latino,29080,2057176,31954.0,1329638,10.0,158295
2021-04-17 15:00:00,Not Hispanic or Latino,24204,2081380,16953.0,1346591,4.0,158299
2021-04-18 15:00:00,Not Hispanic or Latino,14412,2095792,13066.0,1359657,4.0,158303
2021-04-19 15:00:00,Not Hispanic or Latino,22127,2117919,29676.0,1389333,45.0,158348
2021-04-20 15:00:00,Not Hispanic or Latino,23280,2141199,36226.0,1425559,33.0,158381
2021-04-21 15:00:00,Not Hispanic or Latino,29475,2170674,37306.0,1462865,14.0,158395
2021-04-22 15:00:00,Not Hispanic or Latino,28143,2198817,35088.0,1497953,16.0,158411
2021-04-23 15:00:00,Not Hispanic or Latino,24659,2223476,33142.0,1531095,13.0,158424
2021-04-24 15:00:00,Not Hispanic or Latino,18852,2242328,23384.0,1554479,63.0,158487
2021-04-25 15:00:00,Not Hispanic or Latino,13894,2256222,6644.0,1561123,21.0,158508
2021-04-26 15:00:00,Not Hispanic or Latino,20171,2276393,26297.0,1587420,177.0,158685
2021-04-27 15:00:00,Not Hispanic or Latino,20589,2296982,28317.0,1615737,901.0,159586
2021-04-28 15:00:00,Not Hispanic or Latino,22730,2319712,32179.0,1647916,1119.0,160705
2021-04-29 15:00:00,Not Hispanic or Latino,21242,2340954,31536.0,1679452,1211.0,161916
2021-04-30 15:00:00,Not Hispanic or Latino,21404,2362358,25568.0,1705020,1331.0,163247
2021-05-01 15:00:00,Not Hispanic or Latino,13188,2375546,18058.0,1723078,773.0,164020
2021-05-02 15:00:00,Not Hispanic or Latino,6314,2381860,11153.0,1734231,639.0,164659
2021-05-03 15:00:00,Not Hispanic or Latino,9770,2391630,21936.0,1756167,1575.0,166234
2021-05-04 15:00:00,Not Hispanic or Latino,11235,2402865,32053.0,1788220,1442.0,167676
2021-05-05 15:00:00,Not Hispanic or Latino,14207,2417072,28983.0,1817203,1559.0,169235
2021-05-06 15:00:00,Not Hispanic or Latino,13192,2430264,31383.0,1848586,1433.0,170668
2021-05-07 15:00:00,Not Hispanic or Latino,12710,2442974,27489.0,1876075,1616.0,172284
2021-05-08 15:00:00,Not Hispanic or Latino,7249,2450223,22784.0,1898859,1001.0,173285
2021-05-09 15:00:00,Not Hispanic or Latino,3495,2453718,8558.0,1907417,553.0,173838
2021-05-10 15:00:00,Not Hispanic or Latino,6576,2460294,22800.0,1930217,1125.0,174963
2021-05-11 15:00:00,Not Hispanic or Latino,9281,2469575,23545.0,1953762,1192.0,176155
2021-05-12 15:00:00,Not Hispanic or Latino,10800,2480375,29380.0,1983142,1381.0,177536
2021-05-13 15:00:00,Not Hispanic or Latino,17975,2498350,26872.0,2010014,1084.0,178620
2021-05-14 15:00:00,Not Hispanic or Latino,19110,2517460,22635.0,2032649,1385.0,180005
2021-05-15 15:00:00,Not Hispanic or Latino,16274,2533734,17096.0,2049745,1001.0,181006
2021-05-16 15:00:00,Not Hispanic or Latino,6911,2540645,12835.0,2062580,694.0,181700
2021-05-17 15:00:00,Not Hispanic or Latino,13805,2554450,20439.0,2083019,1432.0,183132
2021-05-18 15:00:00,Not Hispanic or Latino,16827,2571277,23413.0,2106432,1487.0,184619
2021-05-19 15:00:00,Not Hispanic or Latino,22375,2593652,24960.0,2131392,1215.0,185834
2021-05-20 15:00:00,Not Hispanic or Latino,15716,2609368,25155.0,2156547,1550.0,187384
2021-05-21 15:00:00,Not Hispanic or Latino,15205,2624573,23115.0,2179662,1179.0,188563
2021-05-22 15:00:00,Not Hispanic or Latino,11341,2635914,14343.0,2194005,777.0,189340
2021-05-23 15:00:00,Not Hispanic or Latino,6062,2641976,7742.0,2201747,588.0,189928
2021-05-24 15:00:00,Not Hispanic or Latino,9851,2651827,12914.0,2214661,1034.0,190962
2021-05-25 15:00:00,Not Hispanic or Latino,9203,2661030,14196.0,2228857,925.0,191887
2021-05-26 15:00:00,Not Hispanic or Latino,13200,2674230,14211.0,2243068,1044.0,192931
2021-05-27 15:00:00,Not Hispanic or Latino,8816,2683046,14082.0,2257150,822.0,193753
2021-05-28 15:00:00,Not Hispanic or Latino,9166,2692212,14519.0,2271669,1014.0,194767
2021-05-29 15:00:00,Not Hispanic or Latino,6212,2698424,7442.0,2279111,539.0,195306
2021-05-30 15:00:00,Not Hispanic or Latino,3373,2701797,4425.0,2283536,340.0,195646
2021-05-31 15:00:00,Not Hispanic or Latino,1153,2702950,2614.0,2286150,186.0,195832
2021-06-01 15:00:00,Not Hispanic or Latino,7140,2710090,12670.0,2298820,812.0,196644
2021-06-02 15:00:00,Not Hispanic or Latino,7580,2717670,13084.0,2311904,723.0,197367
2021-06-03 15:00:00,Not Hispanic or Latino,6025,2723695,17244.0,2329148,829.0,198196
2021-06-04 15:00:00,Not Hispanic or Latino,6282,2729977,17017.0,2346165,835.0,199031
2021-06-05 15:00:00,Not Hispanic or Latino,4894,2734871,15117.0,2361282,531.0,199562
2021-06-06 15:00:00,Not Hispanic or Latino,2296,2737167,5593.0,2366875,237.0,199799
2021-06-07 15:00:00,Not Hispanic or Latino,5019,2742186,13111.0,2379986,555.0,200354
2021-06-08 15:00:00,Not Hispanic or Latino,5151,2747337,15694.0,2395680,589.0,200943
2021-06-09 15:00:00,Not Hispanic or Latino,4310,2751647,15978.0,2411658,588.0,201531
2021-06-10 15:00:00,Not Hispanic or Latino,3663,2755310,11342.0,2423000,487.0,202018
2021-06-11 15:00:00,Not Hispanic or Latino,2467,2757777,7825.0,2430825,515.0,202533
2021-06-12 15:00:00,Not Hispanic or Latino,1859,2759636,7570.0,2438395,259.0,202792
2021-06-13 15:00:00,Not Hispanic or Latino,305,2759941,2095.0,2440490,58.0,202850
