VACCINATION_DATE,Ethnicity,FirstDoseDaily,FirstDoseCumulative,SecondDoseDaily,SecondDoseCumulative,SingleDoseDaily,SingleDoseCumulative
2020-12-14 15:00:00,Unknown,1,1,,0,,0
2020-12-16 15:00:00,Unknown,10,11,,0,,0
2020-12-17 15:00:00,Unknown,20,31,,0,,0
2020-12-18 15:00:00,Unknown,93,124,,0,,0
2020-12-19 15:00:00,Unknown,37,161,,0,,0
2020-12-20 15:00:00,Unknown,29,190,,0,,0
2020-12-21 15:00:00,Unknown,72,262,1.0,1,,0
2020-12-22 15:00:00,Unknown,410,672,,1,,0
2020-12-23 15:00:00,Unknown,200,872,,1,,0
2020-12-24 15:00:00,Unknown,67,939,,1,,0
2020-12-25 15:00:00,Unknown,178,1117,,1,,0
2020-12-26 15:00:00,Unknown,196,1313,,1,,0
2020-12-27 15:00:00,Unknown,141,1454,,1,,0
2020-12-28 15:00:00,Unknown,291,1745,,1,,0
2020-12-29 15:00:00,Unknown,489,2234,,1,,0
2020-12-30 15:00:00,Unknown,378,2612,,1,,0
2020-12-31 15:00:00,Unknown,217,2829,,1,,0
2021-01-01 15:00:00,Unknown,147,2976,2.0,3,,0
2021-01-02 15:00:00,Unknown,174,3150,2.0,5,,0
2021-01-03 15:00:00,Unknown,225,3375,4.0,9,,0
2021-01-04 15:00:00,Unknown,588,3963,6.0,15,,0
2021-01-05 15:00:00,Unknown,516,4479,18.0,33,,0
2021-01-06 15:00:00,Unknown,654,5133,24.0,57,,0
2021-01-07 15:00:00,Unknown,407,5540,57.0,114,,0
2021-01-08 15:00:00,Unknown,8306,13846,76.0,190,,0
2021-01-09 15:00:00,Unknown,224,14070,45.0,235,,0
2021-01-10 15:00:00,Unknown,177,14247,9.0,244,,0
2021-01-11 15:00:00,Unknown,330,14577,85.0,329,,0
2021-01-12 15:00:00,Unknown,701,15278,345.0,674,,0
2021-01-13 15:00:00,Unknown,418,15696,134.0,808,,0
2021-01-14 15:00:00,Unknown,400,16096,62.0,870,,0
2021-01-15 15:00:00,Unknown,556,16652,180.0,1050,,0
2021-01-16 15:00:00,Unknown,292,16944,153.0,1203,,0
2021-01-17 15:00:00,Unknown,111,17055,94.0,1297,,0
2021-01-18 15:00:00,Unknown,164,17219,200.0,1497,,0
2021-01-19 15:00:00,Unknown,334,17553,287.0,1784,,0
2021-01-20 15:00:00,Unknown,420,17973,182.0,1966,,0
2021-01-21 15:00:00,Unknown,509,18482,108.0,2074,,0
2021-01-22 15:00:00,Unknown,730,19212,169.0,2243,,0
2021-01-23 15:00:00,Unknown,460,19672,162.0,2405,,0
2021-01-24 15:00:00,Unknown,202,19874,146.0,2551,,0
2021-01-25 15:00:00,Unknown,601,20475,463.0,3014,,0
2021-01-26 15:00:00,Unknown,682,21157,374.0,3388,,0
2021-01-27 15:00:00,Unknown,617,21774,539.0,3927,,0
2021-01-28 15:00:00,Unknown,594,22368,273.0,4200,,0
2021-01-29 15:00:00,Unknown,658,23026,210.0,4410,,0
2021-01-30 15:00:00,Unknown,481,23507,61.0,4471,,0
2021-01-31 15:00:00,Unknown,437,23944,82.0,4553,,0
2021-02-01 15:00:00,Unknown,480,24424,214.0,4767,,0
2021-02-02 15:00:00,Unknown,662,25086,644.0,5411,,0
2021-02-03 15:00:00,Unknown,803,25889,478.0,5889,,0
2021-02-04 15:00:00,Unknown,892,26781,440.0,6329,,0
2021-02-05 15:00:00,Unknown,725,27506,439.0,6768,,0
2021-02-06 15:00:00,Unknown,585,28091,8207.0,14975,,0
2021-02-07 15:00:00,Unknown,384,28475,89.0,15064,,0
2021-02-08 15:00:00,Unknown,773,29248,319.0,15383,,0
2021-02-09 15:00:00,Unknown,765,30013,347.0,15730,,0
2021-02-10 15:00:00,Unknown,793,30806,459.0,16189,,0
2021-02-11 15:00:00,Unknown,850,31656,449.0,16638,,0
2021-02-12 15:00:00,Unknown,735,32391,592.0,17230,,0
2021-02-13 15:00:00,Unknown,401,32792,179.0,17409,,0
2021-02-14 15:00:00,Unknown,428,33220,121.0,17530,,0
2021-02-15 15:00:00,Unknown,442,33662,534.0,18064,,0
2021-02-16 15:00:00,Unknown,701,34363,811.0,18875,,0
2021-02-17 15:00:00,Unknown,785,35148,613.0,19488,,0
2021-02-18 15:00:00,Unknown,254,35402,269.0,19757,,0
2021-02-19 15:00:00,Unknown,504,35906,544.0,20301,,0
2021-02-20 15:00:00,Unknown,571,36477,586.0,20887,,0
2021-02-21 15:00:00,Unknown,338,36815,397.0,21284,,0
2021-02-22 15:00:00,Unknown,436,37251,525.0,21809,,0
2021-02-23 15:00:00,Unknown,663,37914,514.0,22323,,0
2021-02-24 15:00:00,Unknown,615,38529,601.0,22924,,0
2021-02-25 15:00:00,Unknown,611,39140,842.0,23766,,0
2021-02-26 15:00:00,Unknown,757,39897,846.0,24612,,0
2021-02-27 15:00:00,Unknown,564,40461,442.0,25054,,0
2021-02-28 15:00:00,Unknown,607,41068,229.0,25283,,0
2021-03-01 15:00:00,Unknown,861,41929,552.0,25835,,0
2021-03-02 15:00:00,Unknown,784,42713,559.0,26394,1.0,1
2021-03-03 15:00:00,Unknown,988,43701,599.0,26993,3.0,4
2021-03-04 15:00:00,Unknown,958,44659,672.0,27665,100.0,104
2021-03-05 15:00:00,Unknown,1013,45672,571.0,28236,87.0,191
2021-03-06 15:00:00,Unknown,636,46308,301.0,28537,188.0,379
2021-03-07 15:00:00,Unknown,513,46821,328.0,28865,284.0,663
2021-03-08 15:00:00,Unknown,966,47787,344.0,29209,354.0,1017
2021-03-09 15:00:00,Unknown,933,48720,451.0,29660,363.0,1380
2021-03-10 15:00:00,Unknown,872,49592,480.0,30140,483.0,1863
2021-03-11 15:00:00,Unknown,1302,50894,503.0,30643,203.0,2066
2021-03-12 15:00:00,Unknown,1245,52139,597.0,31240,162.0,2228
2021-03-13 15:00:00,Unknown,831,52970,358.0,31598,74.0,2302
2021-03-14 15:00:00,Unknown,1005,53975,340.0,31938,66.0,2368
2021-03-15 15:00:00,Unknown,1664,55639,414.0,32352,37.0,2405
2021-03-16 15:00:00,Unknown,1624,57263,602.0,32954,41.0,2446
2021-03-17 15:00:00,Unknown,1645,58908,679.0,33633,66.0,2512
2021-03-18 15:00:00,Unknown,1774,60682,482.0,34115,60.0,2572
2021-03-19 15:00:00,Unknown,1467,62149,482.0,34597,59.0,2631
2021-03-20 15:00:00,Unknown,1247,63396,433.0,35030,155.0,2786
2021-03-21 15:00:00,Unknown,1060,64456,475.0,35505,24.0,2810
2021-03-22 15:00:00,Unknown,1550,66006,533.0,36038,33.0,2843
2021-03-23 15:00:00,Unknown,1930,67936,643.0,36681,71.0,2914
2021-03-24 15:00:00,Unknown,2570,70506,547.0,37228,72.0,2986
2021-03-25 15:00:00,Unknown,2603,73109,612.0,37840,325.0,3311
2021-03-26 15:00:00,Unknown,2561,75670,725.0,38565,348.0,3659
2021-03-27 15:00:00,Unknown,2079,77749,516.0,39081,496.0,4155
2021-03-28 15:00:00,Unknown,1853,79602,492.0,39573,411.0,4566
2021-03-29 15:00:00,Unknown,2592,82194,995.0,40568,76.0,4642
2021-03-30 15:00:00,Unknown,2452,84646,1029.0,41597,126.0,4768
2021-03-31 15:00:00,Unknown,2460,87106,926.0,42523,777.0,5545
2021-04-01 15:00:00,Unknown,1579,88685,1300.0,43823,619.0,6164
2021-04-02 15:00:00,Unknown,1836,90521,1353.0,45176,742.0,6906
2021-04-03 15:00:00,Unknown,1626,92147,829.0,46005,650.0,7556
2021-04-04 15:00:00,Unknown,595,92742,645.0,46650,45.0,7601
2021-04-05 15:00:00,Unknown,1859,94601,1165.0,47815,657.0,8258
2021-04-06 15:00:00,Unknown,2197,96798,1274.0,49089,855.0,9113
2021-04-07 15:00:00,Unknown,2440,99238,1364.0,50453,1302.0,10415
2021-04-08 15:00:00,Unknown,3058,102296,1505.0,51958,1475.0,11890
2021-04-09 15:00:00,Unknown,3322,105618,1082.0,53040,1251.0,13141
2021-04-10 15:00:00,Unknown,2926,108544,1031.0,54071,960.0,14101
2021-04-11 15:00:00,Unknown,2457,111001,1048.0,55119,1025.0,15126
2021-04-12 15:00:00,Unknown,2762,113763,1836.0,56955,1062.0,16188
2021-04-13 15:00:00,Unknown,3274,117037,1909.0,58864,34.0,16222
2021-04-14 15:00:00,Unknown,3129,120166,2161.0,61025,10.0,16232
2021-04-15 15:00:00,Unknown,3782,123948,2335.0,63360,14.0,16246
2021-04-16 15:00:00,Unknown,3383,127331,2364.0,65724,2.0,16248
2021-04-17 15:00:00,Unknown,3677,131008,1598.0,67322,1.0,16249
2021-04-18 15:00:00,Unknown,2882,133890,1645.0,68967,,16249
2021-04-19 15:00:00,Unknown,2752,136642,2403.0,71370,2.0,16251
2021-04-20 15:00:00,Unknown,2242,138884,2137.0,73507,,16251
2021-04-21 15:00:00,Unknown,3042,141926,2511.0,76018,1.0,16252
2021-04-22 15:00:00,Unknown,2700,144626,1306.0,77324,,16252
2021-04-23 15:00:00,Unknown,3167,147793,1977.0,79301,2.0,16254
2021-04-24 15:00:00,Unknown,3058,150851,1779.0,81080,3.0,16257
2021-04-25 15:00:00,Unknown,2345,153196,755.0,81835,,16257
2021-04-26 15:00:00,Unknown,1772,154968,1582.0,83417,11.0,16268
2021-04-27 15:00:00,Unknown,2292,157260,1492.0,84909,80.0,16348
2021-04-28 15:00:00,Unknown,2083,159343,2563.0,87472,94.0,16442
2021-04-29 15:00:00,Unknown,1831,161174,2726.0,90198,83.0,16525
2021-04-30 15:00:00,Unknown,1986,163160,2787.0,92985,112.0,16637
2021-05-01 15:00:00,Unknown,1567,164727,2747.0,95732,57.0,16694
2021-05-02 15:00:00,Unknown,1186,165913,2219.0,97951,34.0,16728
2021-05-03 15:00:00,Unknown,778,166691,2777.0,100728,87.0,16815
2021-05-04 15:00:00,Unknown,766,167457,3043.0,103771,102.0,16917
2021-05-05 15:00:00,Unknown,1394,168851,2971.0,106742,114.0,17031
2021-05-06 15:00:00,Unknown,1196,170047,3297.0,110039,96.0,17127
2021-05-07 15:00:00,Unknown,1261,171308,2924.0,112963,113.0,17240
2021-05-08 15:00:00,Unknown,1013,172321,3152.0,116115,107.0,17347
2021-05-09 15:00:00,Unknown,683,173004,1520.0,117635,36.0,17383
2021-05-10 15:00:00,Unknown,626,173630,2887.0,120522,81.0,17464
2021-05-11 15:00:00,Unknown,750,174380,2346.0,122868,85.0,17549
2021-05-12 15:00:00,Unknown,882,175262,2747.0,125615,164.0,17713
2021-05-13 15:00:00,Unknown,1076,176338,2321.0,127936,141.0,17854
2021-05-14 15:00:00,Unknown,1197,177535,2398.0,130334,187.0,18041
2021-05-15 15:00:00,Unknown,1421,178956,2446.0,132780,248.0,18289
2021-05-16 15:00:00,Unknown,565,179521,2106.0,134886,198.0,18487
2021-05-17 15:00:00,Unknown,605,180126,1753.0,136639,225.0,18712
2021-05-18 15:00:00,Unknown,1060,181186,2568.0,139207,190.0,18902
2021-05-19 15:00:00,Unknown,1236,182422,2511.0,141718,166.0,19068
2021-05-20 15:00:00,Unknown,1015,183437,2143.0,143861,176.0,19244
2021-05-21 15:00:00,Unknown,1121,184558,2079.0,145940,197.0,19441
2021-05-22 15:00:00,Unknown,1155,185713,1214.0,147154,233.0,19674
2021-05-23 15:00:00,Unknown,654,186367,1281.0,148435,192.0,19866
2021-05-24 15:00:00,Unknown,610,186977,847.0,149282,225.0,20091
2021-05-25 15:00:00,Unknown,780,187757,869.0,150151,140.0,20231
2021-05-26 15:00:00,Unknown,907,188664,1124.0,151275,183.0,20414
2021-05-27 15:00:00,Unknown,634,189298,995.0,152270,138.0,20552
2021-05-28 15:00:00,Unknown,666,189964,1252.0,153522,184.0,20736
2021-05-29 15:00:00,Unknown,733,190697,1234.0,154756,229.0,20965
2021-05-30 15:00:00,Unknown,369,191066,860.0,155616,140.0,21105
2021-05-31 15:00:00,Unknown,67,191133,203.0,155819,73.0,21178
2021-06-01 15:00:00,Unknown,539,191672,927.0,156746,136.0,21314
2021-06-02 15:00:00,Unknown,530,192202,1011.0,157757,84.0,21398
2021-06-03 15:00:00,Unknown,425,192627,1019.0,158776,104.0,21502
2021-06-04 15:00:00,Unknown,444,193071,1124.0,159900,65.0,21567
2021-06-05 15:00:00,Unknown,491,193562,1173.0,161073,48.0,21615
2021-06-06 15:00:00,Unknown,208,193770,481.0,161554,67.0,21682
2021-06-07 15:00:00,Unknown,355,194125,430.0,161984,54.0,21736
2021-06-08 15:00:00,Unknown,370,194495,781.0,162765,82.0,21818
2021-06-09 15:00:00,Unknown,475,194970,941.0,163706,64.0,21882
2021-06-10 15:00:00,Unknown,462,195432,898.0,164604,71.0,21953
2021-06-11 15:00:00,Unknown,515,195947,898.0,165502,108.0,22061
2021-06-12 15:00:00,Unknown,489,196436,1051.0,166553,87.0,22148
2021-06-13 15:00:00,Unknown,230,196666,487.0,167040,55.0,22203
2021-06-14 15:00:00,Unknown,307,196973,398.0,167438,60.0,22263
2021-06-15 15:00:00,Unknown,377,197350,792.0,168230,107.0,22370
2021-06-16 15:00:00,Unknown,326,197676,712.0,168942,72.0,22442
2021-06-17 15:00:00,Unknown,353,198029,544.0,169486,89.0,22531
2021-06-18 15:00:00,Unknown,366,198395,589.0,170075,58.0,22589
2021-06-19 15:00:00,Unknown,293,198688,629.0,170704,50.0,22639
2021-06-20 15:00:00,Unknown,175,198863,250.0,170954,33.0,22672
2021-06-21 15:00:00,Unknown,316,199179,178.0,171132,31.0,22703
2021-06-22 15:00:00,Unknown,379,199558,501.0,171633,93.0,22796
2021-06-23 15:00:00,Unknown,361,199919,453.0,172086,45.0,22841
2021-06-24 15:00:00,Unknown,350,200269,322.0,172408,44.0,22885
2021-06-25 15:00:00,Unknown,385,200654,347.0,172755,52.0,22937
2021-06-26 15:00:00,Unknown,321,200975,380.0,173135,60.0,22997
2021-06-27 15:00:00,Unknown,254,201229,165.0,173300,15.0,23012
2021-06-28 15:00:00,Unknown,461,201690,219.0,173519,33.0,23045
2021-06-29 15:00:00,Unknown,460,202150,318.0,173837,54.0,23099
2021-06-30 15:00:00,Unknown,417,202567,293.0,174130,40.0,23139
2021-07-01 15:00:00,Unknown,380,202947,349.0,174479,51.0,23190
2021-07-02 15:00:00,Unknown,368,203315,344.0,174823,34.0,23224
2021-07-03 15:00:00,Unknown,313,203628,274.0,175097,23.0,23247
2021-07-04 15:00:00,Unknown,31,203659,14.0,175111,1.0,23248
2021-07-05 15:00:00,Unknown,352,204011,203.0,175314,15.0,23263
2021-07-06 15:00:00,Unknown,344,204355,291.0,175605,59.0,23322
2021-07-07 15:00:00,Unknown,348,204703,232.0,175837,28.0,23350
2021-07-08 15:00:00,Unknown,386,205089,211.0,176048,31.0,23381
2021-07-09 15:00:00,Unknown,338,205427,253.0,176301,63.0,23444
2021-07-10 15:00:00,Unknown,318,205745,216.0,176517,34.0,23478
2021-07-11 15:00:00,Unknown,211,205956,179.0,176696,16.0,23494
2021-07-12 15:00:00,Unknown,302,206258,204.0,176900,20.0,23514
2021-07-13 15:00:00,Unknown,363,206621,206.0,177106,19.0,23533
2021-07-14 15:00:00,Unknown,316,206937,192.0,177298,9.0,23542
2021-07-15 15:00:00,Unknown,441,207378,199.0,177497,10.0,23552
2021-07-16 15:00:00,Unknown,214,207592,96.0,177593,10.0,23562
2021-04-13 15:00:00,Federal Entities,84295,84295,54201.0,54201,2952.0,2952
2021-04-14 15:00:00,Federal Entities,557,84852,11.0,54212,1.0,2953
2021-04-15 15:00:00,Federal Entities,623,85475,823.0,55035,19.0,2972
2021-04-16 15:00:00,Federal Entities,782,86257,1016.0,56051,8.0,2980
2021-04-17 15:00:00,Federal Entities,1136,87393,1177.0,57228,6.0,2986
2021-04-19 15:00:00,Federal Entities,1369,88762,2003.0,59231,9.0,2995
2021-04-20 15:00:00,Federal Entities,3243,92005,2158.0,61389,19.0,3014
2021-04-21 15:00:00,Federal Entities,906,92911,1206.0,62595,4.0,3018
2021-04-22 15:00:00,Federal Entities,1018,93929,458.0,63053,,3018
2021-04-23 15:00:00,Federal Entities,759,94688,632.0,63685,1.0,3019
2021-04-25 15:00:00,Federal Entities,992,95680,2492.0,66177,5.0,3024
2021-04-26 15:00:00,Federal Entities,1483,97163,1672.0,67849,1.0,3025
2021-04-29 15:00:00,Federal Entities,223,97386,865.0,68714,2.0,3027
2021-05-01 15:00:00,Federal Entities,1556,98942,1974.0,70688,14.0,3041
2021-05-02 15:00:00,Federal Entities,1071,100013,1875.0,72563,4.0,3045
2021-05-03 15:00:00,Federal Entities,403,100416,2165.0,74728,4.0,3049
2021-05-04 15:00:00,Federal Entities,28,100444,25.0,74753,,3049
2021-05-05 15:00:00,Federal Entities,365,100809,814.0,75567,,3049
2021-05-06 15:00:00,Federal Entities,275,101084,880.0,76447,3.0,3052
2021-05-07 15:00:00,Federal Entities,274,101358,966.0,77413,8.0,3060
2021-05-08 15:00:00,Federal Entities,297,101655,1312.0,78725,6.0,3066
2021-05-10 15:00:00,Federal Entities,338,101993,1712.0,80437,1.0,3067
2021-05-11 15:00:00,Federal Entities,18,102011,13.0,80450,,3067
2021-05-12 15:00:00,Federal Entities,243,102254,1124.0,81574,,3067
2021-05-14 15:00:00,Federal Entities,290,102544,1022.0,82596,2.0,3069
2021-05-15 15:00:00,Federal Entities,611,103155,1701.0,84297,4.0,3073
2021-05-17 15:00:00,Federal Entities,565,103720,2505.0,86802,11.0,3084
2021-05-18 15:00:00,Federal Entities,164,103884,61.0,86863,2.0,3086
2021-05-20 15:00:00,Federal Entities,885,104769,1024.0,87887,,3086
2021-05-22 15:00:00,Federal Entities,911,105680,1359.0,89246,9.0,3095
2021-05-24 15:00:00,Federal Entities,514,106194,1032.0,90278,8.0,3103
2021-05-25 15:00:00,Federal Entities,5,106199,1.0,90279,2.0,3105
2021-05-27 15:00:00,Federal Entities,425,106624,674.0,90953,1.0,3106
2021-05-28 15:00:00,Federal Entities,418,107042,342.0,91295,,3106
2021-05-29 15:00:00,Federal Entities,267,107309,344.0,91639,10.0,3116
2021-05-31 15:00:00,Federal Entities,214,107523,243.0,91882,3.0,3119
2021-06-01 15:00:00,Federal Entities,30,107553,48.0,91930,,3119
2021-06-16 15:00:00,Federal Entities,2042,109595,3555.0,95485,37.0,3156
2021-06-17 15:00:00,Federal Entities,22,109617,95.0,95580,,3156
2021-06-18 15:00:00,Federal Entities,269,109886,456.0,96036,4.0,3160
2021-06-19 15:00:00,Federal Entities,166,110052,338.0,96374,1.0,3161
2021-06-20 15:00:00,Federal Entities,161,110213,284.0,96658,1.0,3162
2021-06-21 15:00:00,Federal Entities,56,110269,120.0,96778,1.0,3163
2021-06-22 15:00:00,Federal Entities,13,110282,8.0,96786,1.0,3164
2021-06-23 15:00:00,Federal Entities,2,110284,2.0,96788,,3164
2021-06-24 15:00:00,Federal Entities,304,110588,355.0,97143,5.0,3169
2021-06-25 15:00:00,Federal Entities,124,110712,209.0,97352,1.0,3170
2021-06-27 15:00:00,Federal Entities,124,110836,173.0,97525,2.0,3172
2021-06-28 15:00:00,Federal Entities,146,110982,186.0,97711,4.0,3176
2021-06-29 15:00:00,Federal Entities,2,110984,2.0,97713,1.0,3177
2021-07-01 15:00:00,Federal Entities,313,111297,340.0,98053,8.0,3185
2021-07-02 15:00:00,Federal Entities,209,111506,249.0,98302,6.0,3191
2021-07-03 15:00:00,Federal Entities,97,111603,123.0,98425,4.0,3195
2021-07-04 15:00:00,Federal Entities,75,111678,98.0,98523,6.0,3201
2021-07-05 15:00:00,Federal Entities,7,111685,8.0,98531,,3201
2020-12-14 15:00:00,Not Hispanic or Latino,9,9,,0,,0
2020-12-15 15:00:00,Not Hispanic or Latino,26,35,1.0,1,,0
2020-12-16 15:00:00,Not Hispanic or Latino,532,567,1.0,2,,0
2020-12-17 15:00:00,Not Hispanic or Latino,1049,1616,1.0,3,,0
2020-12-18 15:00:00,Not Hispanic or Latino,2784,4400,5.0,8,,0
2020-12-19 15:00:00,Not Hispanic or Latino,831,5231,2.0,10,,0
2020-12-20 15:00:00,Not Hispanic or Latino,259,5490,3.0,13,,0
2020-12-21 15:00:00,Not Hispanic or Latino,3590,9080,8.0,21,,0
2020-12-22 15:00:00,Not Hispanic or Latino,5618,14698,7.0,28,,0
2020-12-23 15:00:00,Not Hispanic or Latino,5291,19989,14.0,42,,0
2020-12-24 15:00:00,Not Hispanic or Latino,2519,22508,6.0,48,,0
2020-12-25 15:00:00,Not Hispanic or Latino,814,23322,2.0,50,,0
2020-12-26 15:00:00,Not Hispanic or Latino,1602,24924,4.0,54,,0
2020-12-27 15:00:00,Not Hispanic or Latino,1577,26501,6.0,60,,0
2020-12-28 15:00:00,Not Hispanic or Latino,8318,34819,18.0,78,,0
2020-12-29 15:00:00,Not Hispanic or Latino,10007,44826,12.0,90,,0
2020-12-30 15:00:00,Not Hispanic or Latino,11506,56332,34.0,124,,0
2020-12-31 15:00:00,Not Hispanic or Latino,6922,63254,16.0,140,,0
2021-01-01 15:00:00,Not Hispanic or Latino,1727,64981,45.0,185,,0
2021-01-02 15:00:00,Not Hispanic or Latino,2634,67615,23.0,208,,0
2021-01-03 15:00:00,Not Hispanic or Latino,2971,70586,65.0,273,,0
2021-01-04 15:00:00,Not Hispanic or Latino,11930,82516,262.0,535,,0
2021-01-05 15:00:00,Not Hispanic or Latino,11351,93867,439.0,974,,0
2021-01-06 15:00:00,Not Hispanic or Latino,13774,107641,754.0,1728,,0
2021-01-07 15:00:00,Not Hispanic or Latino,13626,121267,1545.0,3273,,0
2021-01-08 15:00:00,Not Hispanic or Latino,14636,135903,2505.0,5778,,0
2021-01-09 15:00:00,Not Hispanic or Latino,4628,140531,836.0,6614,,0
2021-01-10 15:00:00,Not Hispanic or Latino,2527,143058,323.0,6937,,0
2021-01-11 15:00:00,Not Hispanic or Latino,12674,155732,3136.0,10073,,0
2021-01-12 15:00:00,Not Hispanic or Latino,15705,171437,4958.0,15031,,0
2021-01-13 15:00:00,Not Hispanic or Latino,17269,188706,3519.0,18550,,0
2021-01-14 15:00:00,Not Hispanic or Latino,16510,205216,1737.0,20287,,0
2021-01-15 15:00:00,Not Hispanic or Latino,17842,223058,1621.0,21908,,0
2021-01-16 15:00:00,Not Hispanic or Latino,5201,228259,1353.0,23261,,0
2021-01-17 15:00:00,Not Hispanic or Latino,1845,230104,1316.0,24577,,0
2021-01-18 15:00:00,Not Hispanic or Latino,6641,236745,2873.0,27450,,0
2021-01-19 15:00:00,Not Hispanic or Latino,16215,252960,4800.0,32250,,0
2021-01-20 15:00:00,Not Hispanic or Latino,20077,273037,4765.0,37015,,0
2021-01-21 15:00:00,Not Hispanic or Latino,22389,295426,3342.0,40357,,0
2021-01-22 15:00:00,Not Hispanic or Latino,27009,322435,3204.0,43561,,0
2021-01-23 15:00:00,Not Hispanic or Latino,9158,331593,1619.0,45180,,0
2021-01-24 15:00:00,Not Hispanic or Latino,2996,334589,1487.0,46667,,0
2021-01-25 15:00:00,Not Hispanic or Latino,15550,350139,7592.0,54259,,0
2021-01-26 15:00:00,Not Hispanic or Latino,16629,366768,8170.0,62429,,0
2021-01-27 15:00:00,Not Hispanic or Latino,23612,390380,11266.0,73695,,0
2021-01-28 15:00:00,Not Hispanic or Latino,21820,412200,8404.0,82099,,0
2021-01-29 15:00:00,Not Hispanic or Latino,24040,436240,7137.0,89236,,0
2021-01-30 15:00:00,Not Hispanic or Latino,17345,453585,2251.0,91487,,0
2021-01-31 15:00:00,Not Hispanic or Latino,3499,457084,1135.0,92622,,0
2021-02-01 15:00:00,Not Hispanic or Latino,6482,463566,4252.0,96874,,0
2021-02-02 15:00:00,Not Hispanic or Latino,11578,475144,12300.0,109174,,0
2021-02-03 15:00:00,Not Hispanic or Latino,17144,492288,16777.0,125951,,0
2021-02-04 15:00:00,Not Hispanic or Latino,20708,512996,14363.0,140314,,0
2021-02-05 15:00:00,Not Hispanic or Latino,18920,531916,15912.0,156226,,0
2021-02-06 15:00:00,Not Hispanic or Latino,11042,542958,5864.0,162090,,0
2021-02-07 15:00:00,Not Hispanic or Latino,5367,548325,1555.0,163645,,0
2021-02-08 15:00:00,Not Hispanic or Latino,11873,560198,12008.0,175653,,0
2021-02-09 15:00:00,Not Hispanic or Latino,15255,575453,12980.0,188633,,0
2021-02-10 15:00:00,Not Hispanic or Latino,17670,593123,20069.0,208702,,0
2021-07-06 15:00:00,Federal Entities,18,111703,22.0,98553,4.0,3205
2021-07-08 15:00:00,Federal Entities,105,111808,155.0,98708,5.0,3210
2021-07-09 15:00:00,Federal Entities,136,111944,203.0,98911,9.0,3219
2021-07-10 15:00:00,Federal Entities,130,112074,140.0,99051,4.0,3223
2021-07-11 15:00:00,Federal Entities,145,112219,137.0,99188,4.0,3227
2021-07-13 15:00:00,Federal Entities,3,112222,1.0,99189,,3227
2021-07-14 15:00:00,Federal Entities,57,112279,57.0,99246,3.0,3230
2021-07-15 15:00:00,Federal Entities,56,112335,90.0,99336,4.0,3234
2021-07-16 15:00:00,Federal Entities,1012,113347,526.0,99862,24.0,3258
2020-12-15 15:00:00,Hispanic or Latino,4,4,,0,,0
2020-12-16 15:00:00,Hispanic or Latino,19,23,,0,,0
2020-12-17 15:00:00,Hispanic or Latino,38,61,,0,,0
2020-12-18 15:00:00,Hispanic or Latino,85,146,,0,,0
2020-12-19 15:00:00,Hispanic or Latino,37,183,,0,,0
2020-12-20 15:00:00,Hispanic or Latino,10,193,,0,,0
2020-12-21 15:00:00,Hispanic or Latino,146,339,1.0,1,,0
2020-12-22 15:00:00,Hispanic or Latino,257,596,,1,,0
2020-12-23 15:00:00,Hispanic or Latino,189,785,1.0,2,,0
2020-12-24 15:00:00,Hispanic or Latino,92,877,,2,,0
2020-12-25 15:00:00,Hispanic or Latino,39,916,,2,,0
2020-12-26 15:00:00,Hispanic or Latino,46,962,,2,,0
2020-12-27 15:00:00,Hispanic or Latino,60,1022,,2,,0
2020-12-28 15:00:00,Hispanic or Latino,264,1286,1.0,3,,0
2020-12-29 15:00:00,Hispanic or Latino,368,1654,2.0,5,,0
2020-12-30 15:00:00,Hispanic or Latino,506,2160,2.0,7,,0
2020-12-31 15:00:00,Hispanic or Latino,329,2489,2.0,9,,0
2021-01-01 15:00:00,Hispanic or Latino,71,2560,6.0,15,,0
2021-01-02 15:00:00,Hispanic or Latino,92,2652,3.0,18,,0
2021-01-03 15:00:00,Hispanic or Latino,124,2776,3.0,21,,0
2021-01-04 15:00:00,Hispanic or Latino,622,3398,12.0,33,,0
2021-01-05 15:00:00,Hispanic or Latino,418,3816,19.0,52,,0
2021-01-06 15:00:00,Hispanic or Latino,603,4419,21.0,73,,0
2021-01-07 15:00:00,Hispanic or Latino,807,5226,61.0,134,,0
2021-01-08 15:00:00,Hispanic or Latino,873,6099,92.0,226,,0
2021-01-09 15:00:00,Hispanic or Latino,195,6294,34.0,260,,0
2021-01-10 15:00:00,Hispanic or Latino,138,6432,22.0,282,,0
2021-01-11 15:00:00,Hispanic or Latino,552,6984,130.0,412,,0
2021-01-12 15:00:00,Hispanic or Latino,739,7723,209.0,621,,0
2021-01-13 15:00:00,Hispanic or Latino,678,8401,132.0,753,,0
2021-01-14 15:00:00,Hispanic or Latino,748,9149,70.0,823,,0
2021-01-15 15:00:00,Hispanic or Latino,880,10029,69.0,892,,0
2021-01-16 15:00:00,Hispanic or Latino,186,10215,42.0,934,,0
2021-01-17 15:00:00,Hispanic or Latino,98,10313,46.0,980,,0
2021-01-18 15:00:00,Hispanic or Latino,166,10479,118.0,1098,,0
2021-01-19 15:00:00,Hispanic or Latino,481,10960,161.0,1259,,0
2021-01-20 15:00:00,Hispanic or Latino,627,11587,189.0,1448,,0
2021-01-21 15:00:00,Hispanic or Latino,760,12347,123.0,1571,,0
2021-01-22 15:00:00,Hispanic or Latino,972,13319,108.0,1679,,0
2021-01-23 15:00:00,Hispanic or Latino,321,13640,69.0,1748,,0
2021-01-24 15:00:00,Hispanic or Latino,90,13730,45.0,1793,,0
2021-01-25 15:00:00,Hispanic or Latino,371,14101,314.0,2107,,0
2021-01-26 15:00:00,Hispanic or Latino,480,14581,239.0,2346,,0
2021-01-27 15:00:00,Hispanic or Latino,752,15333,439.0,2785,,0
2021-01-28 15:00:00,Hispanic or Latino,804,16137,399.0,3184,,0
2021-01-29 15:00:00,Hispanic or Latino,734,16871,304.0,3488,,0
2021-01-30 15:00:00,Hispanic or Latino,509,17380,93.0,3581,,0
2021-01-31 15:00:00,Hispanic or Latino,139,17519,30.0,3611,,0
2021-02-01 15:00:00,Hispanic or Latino,178,17697,164.0,3775,,0
2021-02-02 15:00:00,Hispanic or Latino,418,18115,602.0,4377,,0
2021-02-03 15:00:00,Hispanic or Latino,619,18734,668.0,5045,,0
2021-02-04 15:00:00,Hispanic or Latino,748,19482,720.0,5765,,0
2021-02-05 15:00:00,Hispanic or Latino,776,20258,871.0,6636,,0
2021-02-11 15:00:00,Not Hispanic or Latino,21066,614189,16153.0,224855,,0
2021-02-12 15:00:00,Not Hispanic or Latino,18761,632950,18239.0,243094,,0
2021-02-13 15:00:00,Not Hispanic or Latino,10553,643503,5841.0,248935,,0
2021-02-14 15:00:00,Not Hispanic or Latino,6334,649837,1825.0,250760,,0
2021-02-15 15:00:00,Not Hispanic or Latino,10855,660692,12182.0,262942,,0
2021-02-16 15:00:00,Not Hispanic or Latino,15269,675961,20203.0,283145,,0
2021-02-17 15:00:00,Not Hispanic or Latino,19067,695028,25607.0,308752,,0
2021-02-18 15:00:00,Not Hispanic or Latino,2764,697792,4248.0,313000,,0
2021-02-19 15:00:00,Not Hispanic or Latino,9349,707141,18962.0,331962,,0
2021-02-20 15:00:00,Not Hispanic or Latino,9343,716484,19470.0,351432,,0
2021-02-21 15:00:00,Not Hispanic or Latino,5446,721930,7193.0,358625,,0
2021-02-22 15:00:00,Not Hispanic or Latino,7299,729229,14788.0,373413,,0
2021-02-23 15:00:00,Not Hispanic or Latino,14325,743554,15315.0,388728,,0
2021-02-24 15:00:00,Not Hispanic or Latino,16727,760281,23600.0,412328,,0
2021-02-25 15:00:00,Not Hispanic or Latino,18943,779224,25068.0,437396,,0
2021-02-26 15:00:00,Not Hispanic or Latino,24851,804075,24534.0,461930,,0
2021-02-27 15:00:00,Not Hispanic or Latino,14793,818868,10813.0,472743,,0
2021-02-28 15:00:00,Not Hispanic or Latino,14080,832948,4318.0,477061,,0
2021-03-01 15:00:00,Not Hispanic or Latino,22926,855874,11113.0,488174,,0
2021-03-02 15:00:00,Not Hispanic or Latino,21944,877818,12217.0,500391,23.0,23
2021-03-03 15:00:00,Not Hispanic or Latino,27774,905592,16868.0,517259,141.0,164
2021-03-04 15:00:00,Not Hispanic or Latino,28600,934192,16769.0,534028,3815.0,3979
2021-03-05 15:00:00,Not Hispanic or Latino,26689,960881,17958.0,551986,4604.0,8583
2021-03-06 15:00:00,Not Hispanic or Latino,16126,977007,8215.0,560201,5402.0,13985
2021-03-07 15:00:00,Not Hispanic or Latino,10915,987922,4209.0,564410,5995.0,19980
2021-03-08 15:00:00,Not Hispanic or Latino,23828,1011750,7934.0,572344,7548.0,27528
2021-03-09 15:00:00,Not Hispanic or Latino,24084,1035834,14271.0,586615,7509.0,35037
2021-03-10 15:00:00,Not Hispanic or Latino,27688,1063522,14607.0,601222,6910.0,41947
2021-03-11 15:00:00,Not Hispanic or Latino,33084,1096606,15042.0,616264,3568.0,45515
2021-03-12 15:00:00,Not Hispanic or Latino,33688,1130294,16583.0,632847,2521.0,48036
2021-03-13 15:00:00,Not Hispanic or Latino,20445,1150739,9359.0,642206,1296.0,49332
2021-03-14 15:00:00,Not Hispanic or Latino,15254,1165993,6016.0,648222,805.0,50137
2021-03-15 15:00:00,Not Hispanic or Latino,26303,1192296,10371.0,658593,498.0,50635
2021-03-16 15:00:00,Not Hispanic or Latino,29763,1222059,12292.0,670885,703.0,51338
2021-03-17 15:00:00,Not Hispanic or Latino,33407,1255466,15476.0,686361,1042.0,52380
2021-03-18 15:00:00,Not Hispanic or Latino,36939,1292405,11540.0,697901,1192.0,53572
2021-03-19 15:00:00,Not Hispanic or Latino,33935,1326340,14313.0,712214,897.0,54469
2021-03-20 15:00:00,Not Hispanic or Latino,20956,1347296,8996.0,721210,911.0,55380
2021-03-21 15:00:00,Not Hispanic or Latino,16348,1363644,6746.0,727956,280.0,55660
2021-03-22 15:00:00,Not Hispanic or Latino,28713,1392357,10406.0,738362,761.0,56421
2021-03-23 15:00:00,Not Hispanic or Latino,33083,1425440,15982.0,754344,1331.0,57752
2021-03-24 15:00:00,Not Hispanic or Latino,35246,1460686,19507.0,773851,1089.0,58841
2021-03-25 15:00:00,Not Hispanic or Latino,36404,1497090,19309.0,793160,2073.0,60914
2021-03-26 15:00:00,Not Hispanic or Latino,31401,1528491,24104.0,817264,1951.0,62865
2021-03-27 15:00:00,Not Hispanic or Latino,23452,1551943,15390.0,832654,2114.0,64979
2021-03-28 15:00:00,Not Hispanic or Latino,14026,1565969,11429.0,844083,1130.0,66109
2021-03-29 15:00:00,Not Hispanic or Latino,25109,1591078,24009.0,868092,998.0,67107
2021-03-30 15:00:00,Not Hispanic or Latino,34748,1625826,26668.0,894760,1606.0,68713
2021-03-31 15:00:00,Not Hispanic or Latino,35078,1660904,32263.0,927023,4567.0,73280
2021-04-01 15:00:00,Not Hispanic or Latino,35366,1696270,35955.0,962978,4609.0,77889
2021-04-02 15:00:00,Not Hispanic or Latino,30125,1726395,29164.0,992142,4994.0,82883
2021-04-03 15:00:00,Not Hispanic or Latino,17767,1744162,16614.0,1008756,3482.0,86365
2021-04-04 15:00:00,Not Hispanic or Latino,6953,1751115,8861.0,1017617,853.0,87218
2021-04-05 15:00:00,Not Hispanic or Latino,23698,1774813,26082.0,1043699,5600.0,92818
2021-04-06 15:00:00,Not Hispanic or Latino,34535,1809348,27253.0,1070952,9095.0,101913
2021-04-07 15:00:00,Not Hispanic or Latino,30082,1839430,30796.0,1101748,10733.0,112646
2021-04-08 15:00:00,Not Hispanic or Latino,35943,1875373,32385.0,1134133,11155.0,123801
2021-04-09 15:00:00,Not Hispanic or Latino,27549,1902922,32727.0,1166860,12108.0,135909
2021-02-06 15:00:00,Hispanic or Latino,399,20657,207.0,6843,,0
2021-02-07 15:00:00,Hispanic or Latino,166,20823,65.0,6908,,0
2021-02-08 15:00:00,Hispanic or Latino,548,21371,618.0,7526,,0
2021-02-09 15:00:00,Hispanic or Latino,550,21921,528.0,8054,,0
2021-02-10 15:00:00,Hispanic or Latino,698,22619,693.0,8747,,0
2021-02-11 15:00:00,Hispanic or Latino,865,23484,732.0,9479,,0
2021-02-12 15:00:00,Hispanic or Latino,779,24263,857.0,10336,,0
2021-02-13 15:00:00,Hispanic or Latino,371,24634,224.0,10560,,0
2021-02-14 15:00:00,Hispanic or Latino,277,24911,66.0,10626,,0
2021-02-15 15:00:00,Hispanic or Latino,323,25234,362.0,10988,,0
2021-02-16 15:00:00,Hispanic or Latino,517,25751,537.0,11525,,0
2021-02-17 15:00:00,Hispanic or Latino,694,26445,753.0,12278,,0
2021-02-18 15:00:00,Hispanic or Latino,116,26561,134.0,12412,,0
2021-02-19 15:00:00,Hispanic or Latino,366,26927,774.0,13186,,0
2021-02-20 15:00:00,Hispanic or Latino,365,27292,639.0,13825,,0
2021-02-21 15:00:00,Hispanic or Latino,312,27604,250.0,14075,,0
2021-02-22 15:00:00,Hispanic or Latino,287,27891,420.0,14495,,0
2021-02-23 15:00:00,Hispanic or Latino,532,28423,495.0,14990,,0
2021-02-24 15:00:00,Hispanic or Latino,571,28994,825.0,15815,,0
2021-02-25 15:00:00,Hispanic or Latino,781,29775,831.0,16646,,0
2021-02-26 15:00:00,Hispanic or Latino,1135,30910,853.0,17499,,0
2021-02-27 15:00:00,Hispanic or Latino,671,31581,349.0,17848,,0
2021-02-28 15:00:00,Hispanic or Latino,739,32320,182.0,18030,,0
2021-03-01 15:00:00,Hispanic or Latino,1157,33477,429.0,18459,,0
2021-03-02 15:00:00,Hispanic or Latino,1054,34531,356.0,18815,1.0,1
2021-03-03 15:00:00,Hispanic or Latino,1179,35710,665.0,19480,13.0,14
2021-03-04 15:00:00,Hispanic or Latino,1354,37064,507.0,19987,148.0,162
2021-03-05 15:00:00,Hispanic or Latino,1681,38745,611.0,20598,202.0,364
2021-03-06 15:00:00,Hispanic or Latino,897,39642,272.0,20870,379.0,743
2021-03-07 15:00:00,Hispanic or Latino,582,40224,197.0,21067,290.0,1033
2021-03-08 15:00:00,Hispanic or Latino,1226,41450,311.0,21378,364.0,1397
2021-03-09 15:00:00,Hispanic or Latino,1239,42689,468.0,21846,444.0,1841
2021-03-10 15:00:00,Hispanic or Latino,1402,44091,616.0,22462,532.0,2373
2021-03-11 15:00:00,Hispanic or Latino,1682,45773,671.0,23133,255.0,2628
2021-03-12 15:00:00,Hispanic or Latino,2095,47868,674.0,23807,226.0,2854
2021-03-13 15:00:00,Hispanic or Latino,1214,49082,391.0,24198,212.0,3066
2021-03-14 15:00:00,Hispanic or Latino,1544,50626,218.0,24416,109.0,3175
2021-03-15 15:00:00,Hispanic or Latino,1791,52417,349.0,24765,44.0,3219
2021-03-16 15:00:00,Hispanic or Latino,2072,54489,435.0,25200,20.0,3239
2021-03-17 15:00:00,Hispanic or Latino,2498,56987,601.0,25801,59.0,3298
2021-03-18 15:00:00,Hispanic or Latino,2624,59611,404.0,26205,96.0,3394
2021-03-19 15:00:00,Hispanic or Latino,2633,62244,548.0,26753,82.0,3476
2021-03-20 15:00:00,Hispanic or Latino,2144,64388,426.0,27179,50.0,3526
2021-03-21 15:00:00,Hispanic or Latino,1625,66013,455.0,27634,15.0,3541
2021-03-22 15:00:00,Hispanic or Latino,2252,68265,445.0,28079,32.0,3573
2021-03-23 15:00:00,Hispanic or Latino,2664,70929,625.0,28704,131.0,3704
2021-03-24 15:00:00,Hispanic or Latino,3209,74138,832.0,29536,207.0,3911
2021-03-25 15:00:00,Hispanic or Latino,3360,77498,856.0,30392,113.0,4024
2021-03-26 15:00:00,Hispanic or Latino,2533,80031,1268.0,31660,199.0,4223
2021-03-27 15:00:00,Hispanic or Latino,2240,82271,813.0,32473,153.0,4376
2021-03-28 15:00:00,Hispanic or Latino,1122,83393,549.0,33022,72.0,4448
2021-03-29 15:00:00,Hispanic or Latino,2019,85412,1268.0,34290,60.0,4508
2021-03-30 15:00:00,Hispanic or Latino,2765,88177,1202.0,35492,109.0,4617
2021-03-31 15:00:00,Hispanic or Latino,3440,91617,1364.0,36856,387.0,5004
2021-04-01 15:00:00,Hispanic or Latino,2787,94404,1801.0,38657,301.0,5305
2021-04-02 15:00:00,Hispanic or Latino,2757,97161,1913.0,40570,341.0,5646
2021-04-03 15:00:00,Hispanic or Latino,2117,99278,1002.0,41572,285.0,5931
2021-04-04 15:00:00,Hispanic or Latino,692,99970,572.0,42144,49.0,5980
2021-04-05 15:00:00,Hispanic or Latino,2323,102293,1526.0,43670,361.0,6341
2021-04-06 15:00:00,Hispanic or Latino,3123,105416,1804.0,45474,514.0,6855
2021-04-07 15:00:00,Hispanic or Latino,3545,108961,1775.0,47249,873.0,7728
2021-04-08 15:00:00,Hispanic or Latino,3351,112312,1925.0,49174,1204.0,8932
2021-04-09 15:00:00,Hispanic or Latino,3271,115583,2218.0,51392,1109.0,10041
2021-04-10 15:00:00,Hispanic or Latino,2241,117824,1570.0,52962,614.0,10655
2021-04-11 15:00:00,Hispanic or Latino,2166,119990,1334.0,54296,666.0,11321
2021-04-12 15:00:00,Hispanic or Latino,2200,122190,2134.0,56430,781.0,12102
2021-04-13 15:00:00,Hispanic or Latino,3645,125835,2528.0,58958,29.0,12131
2021-04-14 15:00:00,Hispanic or Latino,4457,130292,2593.0,61551,35.0,12166
2021-04-15 15:00:00,Hispanic or Latino,3705,133997,2271.0,63822,24.0,12190
2021-04-16 15:00:00,Hispanic or Latino,3734,137731,2811.0,66633,,12190
2021-04-17 15:00:00,Hispanic or Latino,3687,141418,1849.0,68482,,12190
2021-04-18 15:00:00,Hispanic or Latino,2417,143835,1201.0,69683,,12190
2021-04-19 15:00:00,Hispanic or Latino,3405,147240,1925.0,71608,6.0,12196
2021-04-20 15:00:00,Hispanic or Latino,3641,150881,2510.0,74118,,12196
2021-04-21 15:00:00,Hispanic or Latino,5181,156062,3303.0,77421,1.0,12197
2021-04-22 15:00:00,Hispanic or Latino,4020,160082,3251.0,80672,,12197
2021-04-23 15:00:00,Hispanic or Latino,3783,163865,3072.0,83744,,12197
2021-04-24 15:00:00,Hispanic or Latino,4354,168219,2582.0,86326,8.0,12205
2021-04-25 15:00:00,Hispanic or Latino,2902,171121,823.0,87149,3.0,12208
2021-04-26 15:00:00,Hispanic or Latino,3624,174745,2438.0,89587,16.0,12224
2021-04-27 15:00:00,Hispanic or Latino,3582,178327,2592.0,92179,112.0,12336
2021-04-28 15:00:00,Hispanic or Latino,3736,182063,3685.0,95864,142.0,12478
2021-04-29 15:00:00,Hispanic or Latino,3666,185729,3126.0,98990,159.0,12637
2021-04-30 15:00:00,Hispanic or Latino,4200,189929,2754.0,101744,179.0,12816
2021-05-01 15:00:00,Hispanic or Latino,3460,193389,2303.0,104047,134.0,12950
2021-05-02 15:00:00,Hispanic or Latino,1627,195016,1624.0,105671,129.0,13079
2021-05-03 15:00:00,Hispanic or Latino,1950,196966,2213.0,107884,235.0,13314
2021-05-04 15:00:00,Hispanic or Latino,1941,198907,3200.0,111084,176.0,13490
2021-05-05 15:00:00,Hispanic or Latino,2945,201852,3869.0,114953,222.0,13712
2021-05-06 15:00:00,Hispanic or Latino,2211,204063,3459.0,118412,165.0,13877
2021-05-07 15:00:00,Hispanic or Latino,3033,207096,3667.0,122079,194.0,14071
2021-05-08 15:00:00,Hispanic or Latino,2044,209140,3227.0,125306,174.0,14245
2021-05-09 15:00:00,Hispanic or Latino,961,210101,1481.0,126787,103.0,14348
2021-05-10 15:00:00,Hispanic or Latino,1317,211418,3105.0,129892,140.0,14488
2021-05-11 15:00:00,Hispanic or Latino,1832,213250,3122.0,133014,154.0,14642
2021-05-12 15:00:00,Hispanic or Latino,2254,215504,4315.0,137329,339.0,14981
2021-05-13 15:00:00,Hispanic or Latino,2536,218040,3485.0,140814,119.0,15100
2021-05-14 15:00:00,Hispanic or Latino,3366,221406,2968.0,143782,186.0,15286
2021-05-15 15:00:00,Hispanic or Latino,3397,224803,3401.0,147183,234.0,15520
2021-05-16 15:00:00,Hispanic or Latino,1405,226208,2317.0,149500,200.0,15720
2021-05-17 15:00:00,Hispanic or Latino,1949,228157,3137.0,152637,198.0,15918
2021-05-18 15:00:00,Hispanic or Latino,2875,231032,3775.0,156412,234.0,16152
2021-05-19 15:00:00,Hispanic or Latino,4087,235119,4011.0,160423,235.0,16387
2021-05-20 15:00:00,Hispanic or Latino,3073,238192,3912.0,164335,225.0,16612
2021-05-21 15:00:00,Hispanic or Latino,2960,241152,4201.0,168536,222.0,16834
2021-05-22 15:00:00,Hispanic or Latino,3259,244411,3412.0,171948,245.0,17079
2021-05-23 15:00:00,Hispanic or Latino,1793,246204,2004.0,173952,169.0,17248
2021-05-24 15:00:00,Hispanic or Latino,2016,248220,2428.0,176380,179.0,17427
2021-05-25 15:00:00,Hispanic or Latino,2161,250381,2471.0,178851,159.0,17586
2021-05-26 15:00:00,Hispanic or Latino,2790,253171,2898.0,181749,160.0,17746
2021-05-27 15:00:00,Hispanic or Latino,1715,254886,2368.0,184117,122.0,17868
2021-05-28 15:00:00,Hispanic or Latino,2173,257059,3112.0,187229,195.0,18063
2021-05-29 15:00:00,Hispanic or Latino,2410,259469,2242.0,189471,145.0,18208
2021-05-30 15:00:00,Hispanic or Latino,1152,260621,1070.0,190541,105.0,18313
2021-05-31 15:00:00,Hispanic or Latino,301,260922,541.0,191082,43.0,18356
2021-06-01 15:00:00,Hispanic or Latino,1742,262664,2183.0,193265,155.0,18511
2021-06-02 15:00:00,Hispanic or Latino,2024,264688,2144.0,195409,123.0,18634
2021-06-03 15:00:00,Hispanic or Latino,1481,266169,2203.0,197612,122.0,18756
2021-06-04 15:00:00,Hispanic or Latino,1536,267705,3214.0,200826,132.0,18888
2021-06-05 15:00:00,Hispanic or Latino,1606,269311,2672.0,203498,122.0,19010
2021-06-06 15:00:00,Hispanic or Latino,989,270300,856.0,204354,87.0,19097
2021-06-07 15:00:00,Hispanic or Latino,1420,271720,1760.0,206114,102.0,19199
2021-06-08 15:00:00,Hispanic or Latino,1304,273024,2552.0,208666,115.0,19314
2021-06-09 15:00:00,Hispanic or Latino,1942,274966,3581.0,212247,141.0,19455
2021-06-10 15:00:00,Hispanic or Latino,1353,276319,2974.0,215221,110.0,19565
2021-06-11 15:00:00,Hispanic or Latino,1637,277956,2695.0,217916,191.0,19756
2021-06-12 15:00:00,Hispanic or Latino,1312,279268,3064.0,220980,116.0,19872
2021-06-13 15:00:00,Hispanic or Latino,550,279818,1477.0,222457,108.0,19980
2021-06-14 15:00:00,Hispanic or Latino,1254,281072,1803.0,224260,126.0,20106
2021-06-15 15:00:00,Hispanic or Latino,1032,282104,2248.0,226508,127.0,20233
2021-06-16 15:00:00,Hispanic or Latino,1407,283511,2639.0,229147,102.0,20335
2021-06-17 15:00:00,Hispanic or Latino,1373,284884,1821.0,230968,105.0,20440
2021-06-18 15:00:00,Hispanic or Latino,1379,286263,2078.0,233046,113.0,20553
2021-06-19 15:00:00,Hispanic or Latino,1059,287322,2053.0,235099,155.0,20708
2021-06-20 15:00:00,Hispanic or Latino,645,287967,1196.0,236295,131.0,20839
2021-06-21 15:00:00,Hispanic or Latino,1240,289207,810.0,237105,108.0,20947
2021-06-22 15:00:00,Hispanic or Latino,1114,290321,1653.0,238758,145.0,21092
2021-06-23 15:00:00,Hispanic or Latino,1290,291611,1890.0,240648,84.0,21176
2021-06-24 15:00:00,Hispanic or Latino,1114,292725,1271.0,241919,105.0,21281
2021-06-25 15:00:00,Hispanic or Latino,1032,293757,1430.0,243349,76.0,21357
2021-06-26 15:00:00,Hispanic or Latino,903,294660,1440.0,244789,114.0,21471
2021-06-27 15:00:00,Hispanic or Latino,693,295353,824.0,245613,64.0,21535
2021-06-28 15:00:00,Hispanic or Latino,892,296245,1212.0,246825,66.0,21601
2021-06-29 15:00:00,Hispanic or Latino,981,297226,1194.0,248019,112.0,21713
2021-06-30 15:00:00,Hispanic or Latino,1096,298322,1477.0,249496,93.0,21806
2021-07-01 15:00:00,Hispanic or Latino,900,299222,1150.0,250646,66.0,21872
2021-07-02 15:00:00,Hispanic or Latino,1117,300339,1369.0,252015,92.0,21964
2021-07-03 15:00:00,Hispanic or Latino,769,301108,878.0,252893,84.0,22048
2021-07-04 15:00:00,Hispanic or Latino,108,301216,96.0,252989,8.0,22056
2021-07-05 15:00:00,Hispanic or Latino,739,301955,797.0,253786,43.0,22099
2021-07-06 15:00:00,Hispanic or Latino,819,302774,1099.0,254885,51.0,22150
2021-07-07 15:00:00,Hispanic or Latino,839,303613,1241.0,256126,50.0,22200
2021-07-08 15:00:00,Hispanic or Latino,879,304492,1202.0,257328,69.0,22269
2021-07-09 15:00:00,Hispanic or Latino,1014,305506,1228.0,258556,80.0,22349
2021-07-10 15:00:00,Hispanic or Latino,840,306346,946.0,259502,45.0,22394
2021-07-11 15:00:00,Hispanic or Latino,819,307165,614.0,260116,72.0,22466
2021-07-12 15:00:00,Hispanic or Latino,792,307957,1038.0,261154,34.0,22500
2021-07-13 15:00:00,Hispanic or Latino,846,308803,877.0,262031,60.0,22560
2021-07-14 15:00:00,Hispanic or Latino,792,309595,1025.0,263056,39.0,22599
2021-07-15 15:00:00,Hispanic or Latino,801,310396,846.0,263902,26.0,22625
2021-07-16 15:00:00,Hispanic or Latino,436,310832,446.0,264348,37.0,22662
2021-04-10 15:00:00,Not Hispanic or Latino,18819,1921741,20208.0,1187068,6043.0,141952
2021-04-11 15:00:00,Not Hispanic or Latino,12931,1934672,10797.0,1197865,8926.0,150878
2021-04-12 15:00:00,Not Hispanic or Latino,19746,1954418,28968.0,1226833,9083.0,159961
2021-04-13 15:00:00,Not Hispanic or Latino,35721,1990139,31798.0,1258631,277.0,160238
2021-04-14 15:00:00,Not Hispanic or Latino,32630,2022769,32805.0,1291436,159.0,160397
2021-04-15 15:00:00,Not Hispanic or Latino,33669,2056438,33480.0,1324916,112.0,160509
2021-04-16 15:00:00,Not Hispanic or Latino,29388,2085826,32338.0,1357254,10.0,160519
2021-04-17 15:00:00,Not Hispanic or Latino,24447,2110273,17169.0,1374423,4.0,160523
2021-04-18 15:00:00,Not Hispanic or Latino,14695,2124968,13246.0,1387669,3.0,160526
2021-04-19 15:00:00,Not Hispanic or Latino,22418,2147386,30016.0,1417685,44.0,160570
2021-04-20 15:00:00,Not Hispanic or Latino,23957,2171343,37058.0,1454743,35.0,160605
2021-04-21 15:00:00,Not Hispanic or Latino,30502,2201845,38699.0,1493442,13.0,160618
2021-04-22 15:00:00,Not Hispanic or Latino,28624,2230469,36024.0,1529466,13.0,160631
2021-04-23 15:00:00,Not Hispanic or Latino,24980,2255449,33724.0,1563190,9.0,160640
2021-04-24 15:00:00,Not Hispanic or Latino,18949,2274398,24041.0,1587231,66.0,160706
2021-04-25 15:00:00,Not Hispanic or Latino,13952,2288350,6748.0,1593979,22.0,160728
2021-04-26 15:00:00,Not Hispanic or Latino,20519,2308869,26838.0,1620817,173.0,160901
2021-04-27 15:00:00,Not Hispanic or Latino,20863,2329732,28694.0,1649511,905.0,161806
2021-04-28 15:00:00,Not Hispanic or Latino,23191,2352923,32942.0,1682453,1121.0,162927
2021-04-29 15:00:00,Not Hispanic or Latino,21666,2374589,32314.0,1714767,1217.0,164144
2021-04-30 15:00:00,Not Hispanic or Latino,21897,2396486,26243.0,1741010,1341.0,165485
2021-05-01 15:00:00,Not Hispanic or Latino,13411,2409897,18878.0,1759888,790.0,166275
2021-05-02 15:00:00,Not Hispanic or Latino,6350,2416247,11211.0,1771099,651.0,166926
2021-05-03 15:00:00,Not Hispanic or Latino,9859,2426106,22261.0,1793360,1580.0,168506
2021-05-04 15:00:00,Not Hispanic or Latino,11463,2437569,33003.0,1826363,1449.0,169955
2021-05-05 15:00:00,Not Hispanic or Latino,14562,2452131,29869.0,1856232,1572.0,171527
2021-05-06 15:00:00,Not Hispanic or Latino,13276,2465407,31958.0,1888190,1444.0,172971
2021-05-07 15:00:00,Not Hispanic or Latino,12850,2478257,28241.0,1916431,1628.0,174599
2021-05-08 15:00:00,Not Hispanic or Latino,7447,2485704,23328.0,1939759,1003.0,175602
2021-05-09 15:00:00,Not Hispanic or Latino,3416,2489120,8811.0,1948570,554.0,176156
2021-05-10 15:00:00,Not Hispanic or Latino,6657,2495777,23298.0,1971868,1130.0,177286
2021-05-11 15:00:00,Not Hispanic or Latino,9584,2505361,24658.0,1996526,1202.0,178488
2021-05-12 15:00:00,Not Hispanic or Latino,10583,2515944,30155.0,2026681,1397.0,179885
2021-05-13 15:00:00,Not Hispanic or Latino,18178,2534122,27427.0,2054108,1091.0,180976
2021-05-14 15:00:00,Not Hispanic or Latino,19477,2553599,23233.0,2077341,1392.0,182368
2021-05-15 15:00:00,Not Hispanic or Latino,16412,2570011,17297.0,2094638,1041.0,183409
2021-05-16 15:00:00,Not Hispanic or Latino,7077,2577088,13003.0,2107641,709.0,184118
2021-05-17 15:00:00,Not Hispanic or Latino,13726,2590814,20832.0,2128473,1514.0,185632
2021-05-18 15:00:00,Not Hispanic or Latino,17151,2607965,24140.0,2152613,1513.0,187145
2021-05-19 15:00:00,Not Hispanic or Latino,22223,2630188,25623.0,2178236,1220.0,188365
2021-05-20 15:00:00,Not Hispanic or Latino,15740,2645928,26001.0,2204237,1560.0,189925
2021-05-21 15:00:00,Not Hispanic or Latino,15274,2661202,23540.0,2227777,1191.0,191116
2021-05-22 15:00:00,Not Hispanic or Latino,11524,2672726,14480.0,2242257,782.0,191898
2021-05-23 15:00:00,Not Hispanic or Latino,6295,2679021,8042.0,2250299,596.0,192494
2021-05-24 15:00:00,Not Hispanic or Latino,10300,2689321,13445.0,2263744,1067.0,193561
2021-05-25 15:00:00,Not Hispanic or Latino,9940,2699261,15339.0,2279083,1026.0,194587
2021-05-26 15:00:00,Not Hispanic or Latino,14484,2713745,15319.0,2294402,1162.0,195749
2021-05-27 15:00:00,Not Hispanic or Latino,8927,2722672,14442.0,2308844,868.0,196617
2021-05-28 15:00:00,Not Hispanic or Latino,9282,2731954,14820.0,2323664,1022.0,197639
2021-05-29 15:00:00,Not Hispanic or Latino,6143,2738097,7709.0,2331373,551.0,198190
2021-05-30 15:00:00,Not Hispanic or Latino,3368,2741465,4511.0,2335884,351.0,198541
2021-05-31 15:00:00,Not Hispanic or Latino,1188,2742653,2647.0,2338531,185.0,198726
2021-06-01 15:00:00,Not Hispanic or Latino,6987,2749640,13172.0,2351703,838.0,199564
2021-06-02 15:00:00,Not Hispanic or Latino,7505,2757145,13514.0,2365217,744.0,200308
2021-06-03 15:00:00,Not Hispanic or Latino,5998,2763143,17806.0,2383023,853.0,201161
2021-06-04 15:00:00,Not Hispanic or Latino,6298,2769441,17603.0,2400626,851.0,202012
2021-06-05 15:00:00,Not Hispanic or Latino,4920,2774361,15399.0,2416025,547.0,202559
2021-06-06 15:00:00,Not Hispanic or Latino,2243,2776604,5794.0,2421819,256.0,202815
2021-06-07 15:00:00,Not Hispanic or Latino,5037,2781641,13428.0,2435247,568.0,203383
2021-06-08 15:00:00,Not Hispanic or Latino,5027,2786668,16234.0,2451481,613.0,203996
2021-06-09 15:00:00,Not Hispanic or Latino,5714,2792382,19213.0,2470694,743.0,204739
2021-06-10 15:00:00,Not Hispanic or Latino,5345,2797727,15051.0,2485745,708.0,205447
2021-06-11 15:00:00,Not Hispanic or Latino,5220,2802947,13875.0,2499620,818.0,206265
2021-06-12 15:00:00,Not Hispanic or Latino,3420,2806367,10448.0,2510068,402.0,206667
2021-06-13 15:00:00,Not Hispanic or Latino,1156,2807523,5539.0,2515607,261.0,206928
2021-06-14 15:00:00,Not Hispanic or Latino,4078,2811601,9494.0,2525101,529.0,207457
2021-06-15 15:00:00,Not Hispanic or Latino,4154,2815755,11135.0,2536236,601.0,208058
2021-06-16 15:00:00,Not Hispanic or Latino,4867,2820622,14405.0,2550641,521.0,208579
2021-06-17 15:00:00,Not Hispanic or Latino,4808,2825430,9608.0,2560249,505.0,209084
2021-06-18 15:00:00,Not Hispanic or Latino,4671,2830101,9257.0,2569506,507.0,209591
2021-06-19 15:00:00,Not Hispanic or Latino,2856,2832957,5891.0,2575397,403.0,209994
2021-06-20 15:00:00,Not Hispanic or Latino,1320,2834277,3045.0,2578442,207.0,210201
2021-06-21 15:00:00,Not Hispanic or Latino,3868,2838145,4118.0,2582560,489.0,210690
2021-06-22 15:00:00,Not Hispanic or Latino,3615,2841760,6574.0,2589134,438.0,211128
2021-06-23 15:00:00,Not Hispanic or Latino,4287,2846047,7772.0,2596906,488.0,211616
2021-06-24 15:00:00,Not Hispanic or Latino,4063,2850110,6128.0,2603034,429.0,212045
2021-06-25 15:00:00,Not Hispanic or Latino,3809,2853919,5965.0,2608999,474.0,212519
2021-06-26 15:00:00,Not Hispanic or Latino,2445,2856364,4372.0,2613371,205.0,212724
2021-06-27 15:00:00,Not Hispanic or Latino,1609,2857973,2304.0,2615675,100.0,212824
2021-06-28 15:00:00,Not Hispanic or Latino,3188,2861161,4324.0,2619999,410.0,213234
2021-06-29 15:00:00,Not Hispanic or Latino,3570,2864731,4873.0,2624872,334.0,213568
2021-06-30 15:00:00,Not Hispanic or Latino,3974,2868705,5454.0,2630326,459.0,214027
2021-07-01 15:00:00,Not Hispanic or Latino,3557,2872262,4939.0,2635265,336.0,214363
2021-07-02 15:00:00,Not Hispanic or Latino,3504,2875766,4725.0,2639990,370.0,214733
2021-07-03 15:00:00,Not Hispanic or Latino,2058,2877824,2748.0,2642738,149.0,214882
2021-07-04 15:00:00,Not Hispanic or Latino,265,2878089,325.0,2643063,45.0,214927
2021-07-05 15:00:00,Not Hispanic or Latino,2587,2880676,2870.0,2645933,215.0,215142
2021-07-06 15:00:00,Not Hispanic or Latino,3246,2883922,4713.0,2650646,321.0,215463
2021-07-07 15:00:00,Not Hispanic or Latino,3197,2887119,4706.0,2655352,342.0,215805
2021-07-08 15:00:00,Not Hispanic or Latino,3306,2890425,4277.0,2659629,351.0,216156
2021-07-09 15:00:00,Not Hispanic or Latino,3712,2894137,4581.0,2664210,370.0,216526
2021-07-10 15:00:00,Not Hispanic or Latino,2304,2896441,2833.0,2667043,203.0,216729
2021-07-11 15:00:00,Not Hispanic or Latino,1412,2897853,1463.0,2668506,120.0,216849
2021-07-12 15:00:00,Not Hispanic or Latino,3220,2901073,3696.0,2672202,304.0,217153
2021-07-13 15:00:00,Not Hispanic or Latino,3238,2904311,3139.0,2675341,211.0,217364
2021-07-14 15:00:00,Not Hispanic or Latino,2991,2907302,3501.0,2678842,267.0,217631
2021-07-15 15:00:00,Not Hispanic or Latino,3056,2910358,3275.0,2682117,190.0,217821
2021-07-16 15:00:00,Not Hispanic or Latino,1434,2911792,1633.0,2683750,139.0,217960
