VACCINATION_DATE,Ethnicity,FirstDoseDaily,FirstDoseCumulative,SecondDoseDaily,SecondDoseCumulative,SingleDoseDaily,SingleDoseCumulative
2020-12-14 15:00:00,Unknown,1,1,,0,,0
2020-12-16 15:00:00,Unknown,9,10,,0,,0
2020-12-17 15:00:00,Unknown,16,26,,0,,0
2020-12-18 15:00:00,Unknown,90,116,,0,,0
2020-12-19 15:00:00,Unknown,26,142,,0,,0
2020-12-20 15:00:00,Unknown,32,174,,0,,0
2020-12-21 15:00:00,Unknown,72,246,,0,,0
2020-12-22 15:00:00,Unknown,453,699,,0,,0
2020-12-23 15:00:00,Unknown,196,895,,0,,0
2020-12-24 15:00:00,Unknown,66,961,,0,,0
2020-12-25 15:00:00,Unknown,198,1159,,0,,0
2020-12-26 15:00:00,Unknown,214,1373,,0,,0
2020-12-27 15:00:00,Unknown,152,1525,,0,,0
2020-12-28 15:00:00,Unknown,295,1820,,0,,0
2020-12-29 15:00:00,Unknown,510,2330,,0,,0
2020-12-30 15:00:00,Unknown,359,2689,,0,,0
2020-12-31 15:00:00,Unknown,211,2900,1.0,1,,0
2021-01-01 15:00:00,Unknown,164,3064,,1,,0
2021-01-02 15:00:00,Unknown,195,3259,1.0,2,,0
2021-01-03 15:00:00,Unknown,265,3524,4.0,6,,0
2021-01-04 15:00:00,Unknown,722,4246,6.0,12,,0
2021-01-05 15:00:00,Unknown,550,4796,17.0,29,,0
2021-01-06 15:00:00,Unknown,644,5440,22.0,51,,0
2021-01-07 15:00:00,Unknown,434,5874,56.0,107,,0
2021-01-08 15:00:00,Unknown,8283,14157,74.0,181,,0
2021-01-09 15:00:00,Unknown,214,14371,41.0,222,,0
2021-01-10 15:00:00,Unknown,174,14545,10.0,232,,0
2021-01-11 15:00:00,Unknown,340,14885,83.0,315,,0
2021-01-12 15:00:00,Unknown,734,15619,368.0,683,,0
2021-01-13 15:00:00,Unknown,429,16048,140.0,823,,0
2021-01-14 15:00:00,Unknown,372,16420,58.0,881,,0
2021-01-15 15:00:00,Unknown,544,16964,189.0,1070,,0
2021-01-16 15:00:00,Unknown,316,17280,170.0,1240,,0
2021-01-17 15:00:00,Unknown,110,17390,109.0,1349,,0
2021-01-18 15:00:00,Unknown,188,17578,231.0,1580,,0
2021-01-19 15:00:00,Unknown,295,17873,260.0,1840,,0
2021-01-20 15:00:00,Unknown,340,18213,148.0,1988,,0
2021-01-21 15:00:00,Unknown,356,18569,65.0,2053,,0
2021-01-22 15:00:00,Unknown,745,19314,219.0,2272,,0
2021-01-23 15:00:00,Unknown,433,19747,167.0,2439,,0
2021-01-24 15:00:00,Unknown,223,19970,177.0,2616,,0
2021-01-25 15:00:00,Unknown,584,20554,520.0,3136,,0
2021-01-26 15:00:00,Unknown,667,21221,367.0,3503,,0
2021-01-27 15:00:00,Unknown,522,21743,565.0,4068,,0
2021-01-28 15:00:00,Unknown,479,22222,281.0,4349,,0
2021-01-29 15:00:00,Unknown,377,22599,160.0,4509,,0
2021-01-30 15:00:00,Unknown,312,22911,42.0,4551,,0
2021-01-31 15:00:00,Unknown,373,23284,92.0,4643,,0
2021-02-01 15:00:00,Unknown,414,23698,189.0,4832,,0
2021-02-02 15:00:00,Unknown,534,24232,624.0,5456,,0
2021-02-03 15:00:00,Unknown,705,24937,516.0,5972,,0
2021-02-04 15:00:00,Unknown,881,25818,404.0,6376,,0
2021-02-05 15:00:00,Unknown,692,26510,414.0,6790,,0
2021-02-06 15:00:00,Unknown,407,26917,216.0,7006,,0
2021-02-07 15:00:00,Unknown,401,27318,87.0,7093,,0
2021-02-08 15:00:00,Unknown,691,28009,243.0,7336,,0
2021-02-09 15:00:00,Unknown,775,28784,299.0,7635,,0
2021-02-10 15:00:00,Unknown,861,29645,409.0,8044,,0
2021-02-11 15:00:00,Unknown,935,30580,384.0,8428,,0
2021-02-12 15:00:00,Unknown,733,31313,558.0,8986,,0
2021-02-13 15:00:00,Unknown,390,31703,154.0,9140,,0
2021-02-14 15:00:00,Unknown,452,32155,146.0,9286,,0
2021-02-15 15:00:00,Unknown,488,32643,507.0,9793,,0
2021-02-16 15:00:00,Unknown,743,33386,679.0,10472,,0
2021-02-17 15:00:00,Unknown,862,34248,465.0,10937,,0
2021-02-18 15:00:00,Unknown,320,34568,234.0,11171,,0
2021-02-19 15:00:00,Unknown,658,35226,418.0,11589,,0
2021-02-20 15:00:00,Unknown,497,35723,369.0,11958,,0
2021-02-21 15:00:00,Unknown,358,36081,269.0,12227,,0
2021-02-22 15:00:00,Unknown,483,36564,418.0,12645,,0
2021-02-23 15:00:00,Unknown,719,37283,353.0,12998,,0
2021-02-24 15:00:00,Unknown,654,37937,507.0,13505,,0
2021-02-25 15:00:00,Unknown,665,38602,819.0,14324,,0
2021-02-26 15:00:00,Unknown,786,39388,674.0,14998,,0
2021-02-27 15:00:00,Unknown,607,39995,265.0,15263,,0
2021-02-28 15:00:00,Unknown,707,40702,153.0,15416,,0
2021-03-01 15:00:00,Unknown,882,41584,471.0,15887,,0
2021-03-02 15:00:00,Unknown,873,42457,518.0,16405,,0
2021-03-03 15:00:00,Unknown,1034,43491,602.0,17007,2.0,2
2021-03-04 15:00:00,Unknown,1055,44546,672.0,17679,50.0,52
2021-03-05 15:00:00,Unknown,1289,45835,562.0,18241,48.0,100
2021-03-06 15:00:00,Unknown,911,46746,311.0,18552,192.0,292
2021-03-07 15:00:00,Unknown,1222,47968,321.0,18873,309.0,601
2021-03-08 15:00:00,Unknown,1107,49075,347.0,19220,380.0,981
2021-03-09 15:00:00,Unknown,1174,50249,460.0,19680,393.0,1374
2021-03-10 15:00:00,Unknown,1020,51269,517.0,20197,517.0,1891
2021-03-11 15:00:00,Unknown,1177,52446,524.0,20721,149.0,2040
2021-03-12 15:00:00,Unknown,1398,53844,537.0,21258,105.0,2145
2021-03-13 15:00:00,Unknown,946,54790,334.0,21592,44.0,2189
2021-03-14 15:00:00,Unknown,1079,55869,318.0,21910,48.0,2237
2021-03-15 15:00:00,Unknown,1954,57823,401.0,22311,31.0,2268
2021-03-16 15:00:00,Unknown,2019,59842,575.0,22886,45.0,2313
2021-03-17 15:00:00,Unknown,1998,61840,693.0,23579,61.0,2374
2021-03-18 15:00:00,Unknown,2274,64114,455.0,24034,52.0,2426
2021-03-19 15:00:00,Unknown,1796,65910,401.0,24435,48.0,2474
2021-03-20 15:00:00,Unknown,1524,67434,447.0,24882,38.0,2512
2021-03-21 15:00:00,Unknown,1382,68816,347.0,25229,18.0,2530
2021-03-22 15:00:00,Unknown,1998,70814,501.0,25730,34.0,2564
2021-03-23 15:00:00,Unknown,2533,73347,623.0,26353,76.0,2640
2021-03-24 15:00:00,Unknown,3149,76496,526.0,26879,72.0,2712
2021-03-25 15:00:00,Unknown,3124,79620,584.0,27463,325.0,3037
2021-03-26 15:00:00,Unknown,2940,82560,656.0,28119,368.0,3405
2021-03-27 15:00:00,Unknown,2190,84750,516.0,28635,416.0,3821
2021-03-28 15:00:00,Unknown,2108,86858,504.0,29139,447.0,4268
2021-03-29 15:00:00,Unknown,3048,89906,926.0,30065,73.0,4341
2021-03-30 15:00:00,Unknown,3100,93006,959.0,31024,118.0,4459
2021-03-31 15:00:00,Unknown,2983,95989,777.0,31801,826.0,5285
2021-04-01 15:00:00,Unknown,2320,98309,950.0,32751,638.0,5923
2021-04-02 15:00:00,Unknown,2195,100504,1173.0,33924,778.0,6701
2021-04-03 15:00:00,Unknown,1909,102413,760.0,34684,678.0,7379
2021-04-04 15:00:00,Unknown,524,102937,464.0,35148,30.0,7409
2020-12-15 15:00:00,Hispanic or Latino,1,1,,0,,0
2020-12-16 15:00:00,Hispanic or Latino,20,21,,0,,0
2020-12-17 15:00:00,Hispanic or Latino,31,52,,0,,0
2020-12-18 15:00:00,Hispanic or Latino,86,138,,0,,0
2020-12-19 15:00:00,Hispanic or Latino,33,171,,0,,0
2020-12-20 15:00:00,Hispanic or Latino,9,180,,0,,0
2020-12-21 15:00:00,Hispanic or Latino,144,324,1.0,1,,0
2020-12-22 15:00:00,Hispanic or Latino,252,576,,1,,0
2020-12-23 15:00:00,Hispanic or Latino,175,751,1.0,2,,0
2020-12-24 15:00:00,Hispanic or Latino,85,836,,2,,0
2020-12-25 15:00:00,Hispanic or Latino,38,874,,2,,0
2020-12-26 15:00:00,Hispanic or Latino,37,911,,2,,0
2020-12-27 15:00:00,Hispanic or Latino,58,969,,2,,0
2020-12-28 15:00:00,Hispanic or Latino,251,1220,,2,,0
2020-12-29 15:00:00,Hispanic or Latino,347,1567,,2,,0
2020-12-30 15:00:00,Hispanic or Latino,502,2069,,2,,0
2020-12-31 15:00:00,Hispanic or Latino,311,2380,,2,,0
2021-01-01 15:00:00,Hispanic or Latino,37,2417,,2,,0
2021-01-02 15:00:00,Hispanic or Latino,77,2494,2.0,4,,0
2021-01-03 15:00:00,Hispanic or Latino,115,2609,3.0,7,,0
2021-01-04 15:00:00,Hispanic or Latino,610,3219,12.0,19,,0
2021-01-05 15:00:00,Hispanic or Latino,397,3616,18.0,37,,0
2021-01-06 15:00:00,Hispanic or Latino,562,4178,20.0,57,,0
2021-01-07 15:00:00,Hispanic or Latino,796,4974,56.0,113,,0
2021-01-08 15:00:00,Hispanic or Latino,860,5834,89.0,202,,0
2021-01-09 15:00:00,Hispanic or Latino,195,6029,32.0,234,,0
2021-01-10 15:00:00,Hispanic or Latino,132,6161,20.0,254,,0
2021-01-11 15:00:00,Hispanic or Latino,544,6705,122.0,376,,0
2021-01-12 15:00:00,Hispanic or Latino,720,7425,201.0,577,,0
2021-01-13 15:00:00,Hispanic or Latino,657,8082,126.0,703,,0
2021-01-14 15:00:00,Hispanic or Latino,742,8824,60.0,763,,0
2021-01-15 15:00:00,Hispanic or Latino,857,9681,68.0,831,,0
2021-01-16 15:00:00,Hispanic or Latino,177,9858,40.0,871,,0
2021-01-17 15:00:00,Hispanic or Latino,99,9957,37.0,908,,0
2021-01-18 15:00:00,Hispanic or Latino,169,10126,107.0,1015,,0
2021-01-19 15:00:00,Hispanic or Latino,457,10583,139.0,1154,,0
2021-01-20 15:00:00,Hispanic or Latino,610,11193,170.0,1324,,0
2021-01-21 15:00:00,Hispanic or Latino,742,11935,107.0,1431,,0
2021-01-22 15:00:00,Hispanic or Latino,949,12884,99.0,1530,,0
2021-01-23 15:00:00,Hispanic or Latino,323,13207,47.0,1577,,0
2021-01-24 15:00:00,Hispanic or Latino,95,13302,32.0,1609,,0
2021-01-25 15:00:00,Hispanic or Latino,363,13665,299.0,1908,,0
2021-01-26 15:00:00,Hispanic or Latino,503,14168,224.0,2132,,0
2021-01-27 15:00:00,Hispanic or Latino,731,14899,420.0,2552,,0
2021-01-28 15:00:00,Hispanic or Latino,785,15684,388.0,2940,,0
2021-01-29 15:00:00,Hispanic or Latino,681,16365,283.0,3223,,0
2021-01-30 15:00:00,Hispanic or Latino,480,16845,89.0,3312,,0
2021-01-31 15:00:00,Hispanic or Latino,133,16978,25.0,3337,,0
2021-02-01 15:00:00,Hispanic or Latino,151,17129,144.0,3481,,0
2021-02-02 15:00:00,Hispanic or Latino,406,17535,587.0,4068,,0
2021-02-03 15:00:00,Hispanic or Latino,605,18140,663.0,4731,,0
2021-02-04 15:00:00,Hispanic or Latino,720,18860,696.0,5427,,0
2021-02-05 15:00:00,Hispanic or Latino,758,19618,854.0,6281,,0
2021-02-06 15:00:00,Hispanic or Latino,379,19997,198.0,6479,,0
2021-02-07 15:00:00,Hispanic or Latino,165,20162,56.0,6535,,0
2021-02-08 15:00:00,Hispanic or Latino,515,20677,584.0,7119,,0
2021-02-09 15:00:00,Hispanic or Latino,550,21227,511.0,7630,,0
2021-02-10 15:00:00,Hispanic or Latino,682,21909,671.0,8301,,0
2021-02-11 15:00:00,Hispanic or Latino,856,22765,713.0,9014,,0
2021-02-12 15:00:00,Hispanic or Latino,756,23521,826.0,9840,,0
2021-02-13 15:00:00,Hispanic or Latino,359,23880,223.0,10063,,0
2021-02-14 15:00:00,Hispanic or Latino,273,24153,61.0,10124,,0
2021-02-15 15:00:00,Hispanic or Latino,312,24465,346.0,10470,,0
2021-02-16 15:00:00,Hispanic or Latino,501,24966,534.0,11004,,0
2021-02-17 15:00:00,Hispanic or Latino,689,25655,734.0,11738,,0
2021-02-18 15:00:00,Hispanic or Latino,119,25774,121.0,11859,,0
2021-02-19 15:00:00,Hispanic or Latino,371,26145,743.0,12602,,0
2021-02-20 15:00:00,Hispanic or Latino,363,26508,614.0,13216,,0
2021-02-21 15:00:00,Hispanic or Latino,304,26812,239.0,13455,,0
2021-02-22 15:00:00,Hispanic or Latino,287,27099,409.0,13864,,0
2021-02-23 15:00:00,Hispanic or Latino,512,27611,485.0,14349,,0
2021-02-24 15:00:00,Hispanic or Latino,553,28164,783.0,15132,,0
2021-02-25 15:00:00,Hispanic or Latino,752,28916,804.0,15936,,0
2021-02-26 15:00:00,Hispanic or Latino,1094,30010,821.0,16757,,0
2021-02-27 15:00:00,Hispanic or Latino,645,30655,341.0,17098,,0
2021-02-28 15:00:00,Hispanic or Latino,704,31359,172.0,17270,,0
2021-03-01 15:00:00,Hispanic or Latino,1088,32447,401.0,17671,,0
2021-03-02 15:00:00,Hispanic or Latino,1028,33475,337.0,18008,,0
2021-03-03 15:00:00,Hispanic or Latino,1107,34582,637.0,18645,9.0,9
2021-03-04 15:00:00,Hispanic or Latino,1335,35917,478.0,19123,137.0,146
2021-03-05 15:00:00,Hispanic or Latino,1602,37519,597.0,19720,175.0,321
2021-03-06 15:00:00,Hispanic or Latino,867,38386,273.0,19993,379.0,700
2021-03-07 15:00:00,Hispanic or Latino,528,38914,191.0,20184,279.0,979
2021-03-08 15:00:00,Hispanic or Latino,1182,40096,281.0,20465,357.0,1336
2021-03-09 15:00:00,Hispanic or Latino,1198,41294,473.0,20938,432.0,1768
2021-03-10 15:00:00,Hispanic or Latino,1344,42638,605.0,21543,514.0,2282
2021-03-11 15:00:00,Hispanic or Latino,1487,44125,655.0,22198,225.0,2507
2021-03-12 15:00:00,Hispanic or Latino,1950,46075,611.0,22809,190.0,2697
2021-03-13 15:00:00,Hispanic or Latino,1089,47164,350.0,23159,205.0,2902
2021-03-14 15:00:00,Hispanic or Latino,1356,48520,172.0,23331,96.0,2998
2021-03-15 15:00:00,Hispanic or Latino,1663,50183,312.0,23643,43.0,3041
2021-03-16 15:00:00,Hispanic or Latino,1943,52126,403.0,24046,18.0,3059
2021-03-17 15:00:00,Hispanic or Latino,2393,54519,565.0,24611,59.0,3118
2021-03-18 15:00:00,Hispanic or Latino,2525,57044,378.0,24989,87.0,3205
2021-03-19 15:00:00,Hispanic or Latino,2456,59500,488.0,25477,76.0,3281
2021-03-20 15:00:00,Hispanic or Latino,2060,61560,403.0,25880,46.0,3327
2021-03-21 15:00:00,Hispanic or Latino,1555,63115,429.0,26309,12.0,3339
2021-03-22 15:00:00,Hispanic or Latino,2140,65255,409.0,26718,30.0,3369
2021-03-23 15:00:00,Hispanic or Latino,2517,67772,589.0,27307,133.0,3502
2021-03-24 15:00:00,Hispanic or Latino,3102,70874,797.0,28104,199.0,3701
2021-03-25 15:00:00,Hispanic or Latino,3261,74135,801.0,28905,109.0,3810
2021-03-26 15:00:00,Hispanic or Latino,2424,76559,1211.0,30116,195.0,4005
2021-03-27 15:00:00,Hispanic or Latino,2166,78725,788.0,30904,131.0,4136
2021-03-28 15:00:00,Hispanic or Latino,1060,79785,518.0,31422,69.0,4205
2021-03-29 15:00:00,Hispanic or Latino,1941,81726,1189.0,32611,57.0,4262
2021-03-30 15:00:00,Hispanic or Latino,2611,84337,1139.0,33750,108.0,4370
2021-03-31 15:00:00,Hispanic or Latino,3240,87577,1270.0,35020,376.0,4746
2021-04-01 15:00:00,Hispanic or Latino,2757,90334,1596.0,36616,249.0,4995
2021-04-02 15:00:00,Hispanic or Latino,2357,92691,1713.0,38329,291.0,5286
2021-04-03 15:00:00,Hispanic or Latino,1741,94432,811.0,39140,236.0,5522
2021-04-04 15:00:00,Hispanic or Latino,134,94566,215.0,39355,19.0,5541
2020-12-14 15:00:00,Not Hispanic or Latino,2,2,,0,,0
2020-12-15 15:00:00,Not Hispanic or Latino,8,10,,0,,0
2020-12-16 15:00:00,Not Hispanic or Latino,511,521,1.0,1,,0
2020-12-17 15:00:00,Not Hispanic or Latino,996,1517,,1,,0
2020-12-18 15:00:00,Not Hispanic or Latino,2680,4197,1.0,2,,0
2020-12-19 15:00:00,Not Hispanic or Latino,786,4983,1.0,3,,0
2020-12-20 15:00:00,Not Hispanic or Latino,236,5219,,3,,0
2020-12-21 15:00:00,Not Hispanic or Latino,3500,8719,,3,,0
2020-12-22 15:00:00,Not Hispanic or Latino,5466,14185,2.0,5,,0
2020-12-23 15:00:00,Not Hispanic or Latino,5081,19266,3.0,8,,0
2020-12-24 15:00:00,Not Hispanic or Latino,2481,21747,1.0,9,,0
2020-12-25 15:00:00,Not Hispanic or Latino,794,22541,,9,,0
2020-12-26 15:00:00,Not Hispanic or Latino,1394,23935,1.0,10,,0
2020-12-27 15:00:00,Not Hispanic or Latino,1555,25490,1.0,11,,0
2020-12-28 15:00:00,Not Hispanic or Latino,8039,33529,5.0,16,,0
2020-12-29 15:00:00,Not Hispanic or Latino,9444,42973,4.0,20,,0
2020-12-30 15:00:00,Not Hispanic or Latino,11293,54266,5.0,25,,0
2020-12-31 15:00:00,Not Hispanic or Latino,6778,61044,2.0,27,,0
2021-01-01 15:00:00,Not Hispanic or Latino,1280,62324,15.0,42,,0
2021-01-02 15:00:00,Not Hispanic or Latino,2311,64635,18.0,60,,0
2021-01-03 15:00:00,Not Hispanic or Latino,2768,67403,60.0,120,,0
2021-01-04 15:00:00,Not Hispanic or Latino,11465,78868,227.0,347,,0
2021-01-05 15:00:00,Not Hispanic or Latino,10712,89580,394.0,741,,0
2021-01-06 15:00:00,Not Hispanic or Latino,13097,102677,722.0,1463,,0
2021-01-07 15:00:00,Not Hispanic or Latino,13344,116021,1473.0,2936,,0
2021-01-08 15:00:00,Not Hispanic or Latino,14241,130262,2387.0,5323,,0
2021-01-09 15:00:00,Not Hispanic or Latino,4368,134630,790.0,6113,,0
2021-01-10 15:00:00,Not Hispanic or Latino,2259,136889,296.0,6409,,0
2021-01-11 15:00:00,Not Hispanic or Latino,12375,149264,3037.0,9446,,0
2021-01-12 15:00:00,Not Hispanic or Latino,15169,164433,4725.0,14171,,0
2021-01-13 15:00:00,Not Hispanic or Latino,16721,181154,3357.0,17528,,0
2021-01-14 15:00:00,Not Hispanic or Latino,16122,197276,1692.0,19220,,0
2021-01-15 15:00:00,Not Hispanic or Latino,17432,214708,1516.0,20736,,0
2021-01-16 15:00:00,Not Hispanic or Latino,5094,219802,1092.0,21828,,0
2021-01-17 15:00:00,Not Hispanic or Latino,1809,221611,1174.0,23002,,0
2021-01-18 15:00:00,Not Hispanic or Latino,6747,228358,2531.0,25533,,0
2021-01-19 15:00:00,Not Hispanic or Latino,15491,243849,4139.0,29672,,0
2021-01-20 15:00:00,Not Hispanic or Latino,19510,263359,4458.0,34130,,0
2021-01-21 15:00:00,Not Hispanic or Latino,21705,285064,2988.0,37118,,0
2021-01-22 15:00:00,Not Hispanic or Latino,26503,311567,2876.0,39994,,0
2021-01-23 15:00:00,Not Hispanic or Latino,8674,320241,1267.0,41261,,0
2021-01-24 15:00:00,Not Hispanic or Latino,2918,323159,1352.0,42613,,0
2021-01-25 15:00:00,Not Hispanic or Latino,15198,338357,7266.0,49879,,0
2021-01-26 15:00:00,Not Hispanic or Latino,16079,354436,7636.0,57515,,0
2021-01-27 15:00:00,Not Hispanic or Latino,22680,377116,10891.0,68406,,0
2021-01-28 15:00:00,Not Hispanic or Latino,20856,397972,8165.0,76571,,0
2021-01-29 15:00:00,Not Hispanic or Latino,22566,420538,6246.0,82817,,0
2021-01-30 15:00:00,Not Hispanic or Latino,16511,437049,2120.0,84937,,0
2021-01-31 15:00:00,Not Hispanic or Latino,3134,440183,1070.0,86007,,0
2021-02-01 15:00:00,Not Hispanic or Latino,5739,445922,3682.0,89689,,0
2021-02-02 15:00:00,Not Hispanic or Latino,10722,456644,11789.0,101478,,0
2021-02-03 15:00:00,Not Hispanic or Latino,16104,472748,16429.0,117907,,0
2021-02-04 15:00:00,Not Hispanic or Latino,19814,492562,13932.0,131839,,0
2021-02-05 15:00:00,Not Hispanic or Latino,18338,510900,15409.0,147248,,0
2021-02-06 15:00:00,Not Hispanic or Latino,10207,521107,5616.0,152864,,0
2021-02-07 15:00:00,Not Hispanic or Latino,5170,526277,1404.0,154268,,0
2021-02-08 15:00:00,Not Hispanic or Latino,11309,537586,11488.0,165756,,0
2021-02-09 15:00:00,Not Hispanic or Latino,14715,552301,12358.0,178114,,0
2021-02-10 15:00:00,Not Hispanic or Latino,17279,569580,19493.0,197607,,0
2021-02-11 15:00:00,Not Hispanic or Latino,20785,590365,15517.0,213124,,0
2021-02-12 15:00:00,Not Hispanic or Latino,18181,608546,17569.0,230693,,0
2021-02-13 15:00:00,Not Hispanic or Latino,10121,618667,5537.0,236230,,0
2021-02-14 15:00:00,Not Hispanic or Latino,6151,624818,1695.0,237925,,0
2021-02-15 15:00:00,Not Hispanic or Latino,10852,635670,11150.0,249075,,0
2021-02-16 15:00:00,Not Hispanic or Latino,15191,650861,19121.0,268196,,0
2021-02-17 15:00:00,Not Hispanic or Latino,18929,669790,24350.0,292546,,0
2021-02-18 15:00:00,Not Hispanic or Latino,2884,672674,3790.0,296336,,0
2021-02-19 15:00:00,Not Hispanic or Latino,9690,682364,17620.0,313956,,0
2021-02-20 15:00:00,Not Hispanic or Latino,9175,691539,18656.0,332612,,0
2021-02-21 15:00:00,Not Hispanic or Latino,5368,696907,6667.0,339279,,0
2021-02-22 15:00:00,Not Hispanic or Latino,7306,704213,13946.0,353225,,0
2021-02-23 15:00:00,Not Hispanic or Latino,14185,718398,14356.0,367581,,0
2021-02-24 15:00:00,Not Hispanic or Latino,16532,734930,22794.0,390375,,0
2021-02-25 15:00:00,Not Hispanic or Latino,18490,753420,24145.0,414520,,0
2021-02-26 15:00:00,Not Hispanic or Latino,24245,777665,23755.0,438275,,0
2021-02-27 15:00:00,Not Hispanic or Latino,14440,792105,10022.0,448297,,0
2021-02-28 15:00:00,Not Hispanic or Latino,13933,806038,4011.0,452308,,0
2021-03-01 15:00:00,Not Hispanic or Latino,21946,827984,10275.0,462583,,0
2021-03-02 15:00:00,Not Hispanic or Latino,21243,849227,11826.0,474409,8.0,8
2021-03-03 15:00:00,Not Hispanic or Latino,26865,876092,16412.0,490821,104.0,112
2021-03-04 15:00:00,Not Hispanic or Latino,27867,903959,16322.0,507143,3383.0,3495
2021-03-05 15:00:00,Not Hispanic or Latino,25352,929311,17320.0,524463,4123.0,7618
2021-03-06 15:00:00,Not Hispanic or Latino,15642,944953,7969.0,532432,5342.0,12960
2021-03-07 15:00:00,Not Hispanic or Latino,10141,955094,3926.0,536358,5965.0,18925
2021-03-08 15:00:00,Not Hispanic or Latino,22864,977958,7669.0,544027,7388.0,26313
2021-03-09 15:00:00,Not Hispanic or Latino,22988,1000946,13931.0,557958,7397.0,33710
2021-03-10 15:00:00,Not Hispanic or Latino,26446,1027392,14271.0,572229,6825.0,40535
2021-03-11 15:00:00,Not Hispanic or Latino,30402,1057794,14563.0,586792,3190.0,43725
2021-03-12 15:00:00,Not Hispanic or Latino,32068,1089862,14805.0,601597,2003.0,45728
2021-03-13 15:00:00,Not Hispanic or Latino,19099,1108961,8030.0,609627,1080.0,46808
2021-03-14 15:00:00,Not Hispanic or Latino,13758,1122719,4850.0,614477,642.0,47450
2021-03-15 15:00:00,Not Hispanic or Latino,24853,1147572,9629.0,624106,457.0,47907
2021-03-16 15:00:00,Not Hispanic or Latino,28532,1176104,11989.0,636095,683.0,48590
2021-03-17 15:00:00,Not Hispanic or Latino,32136,1208240,15060.0,651155,1013.0,49603
2021-03-18 15:00:00,Not Hispanic or Latino,35563,1243803,10828.0,661983,1000.0,50603
2021-03-19 15:00:00,Not Hispanic or Latino,32236,1276039,13384.0,675367,853.0,51456
2021-03-20 15:00:00,Not Hispanic or Latino,20256,1296295,8785.0,684152,548.0,52004
2021-03-21 15:00:00,Not Hispanic or Latino,15664,1311959,6486.0,690638,258.0,52262
2021-03-22 15:00:00,Not Hispanic or Latino,27629,1339588,9797.0,700435,745.0,53007
2021-03-23 15:00:00,Not Hispanic or Latino,31820,1371408,15193.0,715628,1285.0,54292
2021-03-24 15:00:00,Not Hispanic or Latino,33967,1405375,18811.0,734439,965.0,55257
2021-03-25 15:00:00,Not Hispanic or Latino,35139,1440514,18347.0,752786,1881.0,57138
2021-03-26 15:00:00,Not Hispanic or Latino,30367,1470881,22837.0,775623,1856.0,58994
2021-03-27 15:00:00,Not Hispanic or Latino,21949,1492830,14791.0,790414,1805.0,60799
2021-03-28 15:00:00,Not Hispanic or Latino,13424,1506254,10979.0,801393,1082.0,61881
2021-03-29 15:00:00,Not Hispanic or Latino,24157,1530411,22856.0,824249,952.0,62833
2021-03-30 15:00:00,Not Hispanic or Latino,32901,1563312,25381.0,849630,1486.0,64319
2021-03-31 15:00:00,Not Hispanic or Latino,33453,1596765,30705.0,880335,4348.0,68667
2021-04-01 15:00:00,Not Hispanic or Latino,34536,1631301,32872.0,913207,4235.0,72902
2021-04-02 15:00:00,Not Hispanic or Latino,25987,1657288,25872.0,939079,4128.0,77030
2021-04-03 15:00:00,Not Hispanic or Latino,14690,1671978,13510.0,952589,2878.0,79908
2021-04-04 15:00:00,Not Hispanic or Latino,974,1672952,2994.0,955583,283.0,80191
