VACCINATION_DATE,Ethnicity,FirstDoseDaily,FirstDoseCumulative,SecondDoseDaily,SecondDoseCumulative,SingleDoseDaily,SingleDoseCumulative
2020-12-14 15:00:00,Unknown,1,1,,0,,0
2020-12-16 15:00:00,Unknown,10,11,,0,,0
2020-12-17 15:00:00,Unknown,20,31,,0,,0
2020-12-18 15:00:00,Unknown,92,123,,0,,0
2020-12-19 15:00:00,Unknown,33,156,,0,,0
2020-12-20 15:00:00,Unknown,29,185,,0,,0
2020-12-21 15:00:00,Unknown,67,252,1.0,1,,0
2020-12-22 15:00:00,Unknown,400,652,,1,,0
2020-12-23 15:00:00,Unknown,191,843,,1,,0
2020-12-24 15:00:00,Unknown,62,905,,1,,0
2020-12-25 15:00:00,Unknown,180,1085,,1,,0
2020-12-26 15:00:00,Unknown,193,1278,,1,,0
2020-12-27 15:00:00,Unknown,141,1419,,1,,0
2020-12-28 15:00:00,Unknown,279,1698,,1,,0
2020-12-29 15:00:00,Unknown,480,2178,,1,,0
2020-12-30 15:00:00,Unknown,367,2545,,1,,0
2020-12-31 15:00:00,Unknown,216,2761,,1,,0
2021-01-01 15:00:00,Unknown,147,2908,2.0,3,,0
2021-01-02 15:00:00,Unknown,167,3075,2.0,5,,0
2021-01-03 15:00:00,Unknown,226,3301,4.0,9,,0
2021-01-04 15:00:00,Unknown,580,3881,6.0,15,,0
2021-01-05 15:00:00,Unknown,507,4388,18.0,33,,0
2021-01-06 15:00:00,Unknown,649,5037,24.0,57,,0
2021-01-07 15:00:00,Unknown,387,5424,57.0,114,,0
2021-01-08 15:00:00,Unknown,8301,13725,74.0,188,,0
2021-01-09 15:00:00,Unknown,219,13944,43.0,231,,0
2021-01-10 15:00:00,Unknown,176,14120,9.0,240,,0
2021-01-11 15:00:00,Unknown,327,14447,79.0,319,,0
2021-01-12 15:00:00,Unknown,699,15146,332.0,651,,0
2021-01-13 15:00:00,Unknown,415,15561,130.0,781,,0
2021-01-14 15:00:00,Unknown,399,15960,61.0,842,,0
2021-01-15 15:00:00,Unknown,555,16515,179.0,1021,,0
2021-01-16 15:00:00,Unknown,292,16807,154.0,1175,,0
2021-01-17 15:00:00,Unknown,108,16915,95.0,1270,,0
2021-01-18 15:00:00,Unknown,160,17075,198.0,1468,,0
2021-01-19 15:00:00,Unknown,333,17408,285.0,1753,,0
2021-01-20 15:00:00,Unknown,420,17828,168.0,1921,,0
2021-01-21 15:00:00,Unknown,511,18339,100.0,2021,,0
2021-01-22 15:00:00,Unknown,728,19067,163.0,2184,,0
2021-01-23 15:00:00,Unknown,455,19522,159.0,2343,,0
2021-01-24 15:00:00,Unknown,199,19721,147.0,2490,,0
2021-01-25 15:00:00,Unknown,602,20323,459.0,2949,,0
2021-01-26 15:00:00,Unknown,683,21006,370.0,3319,,0
2021-01-27 15:00:00,Unknown,617,21623,531.0,3850,,0
2021-01-28 15:00:00,Unknown,594,22217,270.0,4120,,0
2021-01-29 15:00:00,Unknown,658,22875,205.0,4325,,0
2021-01-30 15:00:00,Unknown,477,23352,51.0,4376,,0
2021-01-31 15:00:00,Unknown,437,23789,82.0,4458,,0
2021-02-01 15:00:00,Unknown,478,24267,212.0,4670,,0
2021-02-02 15:00:00,Unknown,660,24927,634.0,5304,,0
2021-02-03 15:00:00,Unknown,806,25733,475.0,5779,,0
2021-02-04 15:00:00,Unknown,892,26625,432.0,6211,,0
2021-02-05 15:00:00,Unknown,728,27353,438.0,6649,,0
2021-02-06 15:00:00,Unknown,585,27938,8205.0,14854,,0
2021-02-07 15:00:00,Unknown,384,28322,89.0,14943,,0
2021-04-13 15:00:00,Federal Entities,84295,84295,54201.0,54201,2952.0,2952
2021-04-14 15:00:00,Federal Entities,557,84852,11.0,54212,1.0,2953
2021-04-15 15:00:00,Federal Entities,623,85475,823.0,55035,19.0,2972
2021-04-16 15:00:00,Federal Entities,782,86257,1016.0,56051,8.0,2980
2021-04-17 15:00:00,Federal Entities,1136,87393,1177.0,57228,6.0,2986
2021-04-19 15:00:00,Federal Entities,1369,88762,2003.0,59231,9.0,2995
2021-04-20 15:00:00,Federal Entities,3243,92005,2158.0,61389,19.0,3014
2021-04-21 15:00:00,Federal Entities,906,92911,1206.0,62595,4.0,3018
2021-04-22 15:00:00,Federal Entities,1018,93929,458.0,63053,,3018
2021-04-23 15:00:00,Federal Entities,759,94688,632.0,63685,1.0,3019
2021-04-25 15:00:00,Federal Entities,992,95680,2492.0,66177,5.0,3024
2021-04-26 15:00:00,Federal Entities,1483,97163,1672.0,67849,1.0,3025
2021-04-29 15:00:00,Federal Entities,223,97386,865.0,68714,2.0,3027
2021-05-01 15:00:00,Federal Entities,1556,98942,1974.0,70688,14.0,3041
2021-05-02 15:00:00,Federal Entities,1071,100013,1875.0,72563,4.0,3045
2021-05-03 15:00:00,Federal Entities,403,100416,2165.0,74728,4.0,3049
2021-05-04 15:00:00,Federal Entities,28,100444,25.0,74753,,3049
2021-05-05 15:00:00,Federal Entities,365,100809,814.0,75567,,3049
2021-05-06 15:00:00,Federal Entities,275,101084,880.0,76447,3.0,3052
2021-05-07 15:00:00,Federal Entities,274,101358,966.0,77413,8.0,3060
2021-05-08 15:00:00,Federal Entities,297,101655,1312.0,78725,6.0,3066
2021-05-10 15:00:00,Federal Entities,338,101993,1712.0,80437,1.0,3067
2021-05-11 15:00:00,Federal Entities,18,102011,13.0,80450,,3067
2021-05-12 15:00:00,Federal Entities,243,102254,1124.0,81574,,3067
2021-05-14 15:00:00,Federal Entities,290,102544,1022.0,82596,2.0,3069
2021-05-15 15:00:00,Federal Entities,611,103155,1701.0,84297,4.0,3073
2021-05-17 15:00:00,Federal Entities,565,103720,2505.0,86802,11.0,3084
2021-05-18 15:00:00,Federal Entities,164,103884,61.0,86863,2.0,3086
2021-05-20 15:00:00,Federal Entities,885,104769,1024.0,87887,,3086
2021-05-22 15:00:00,Federal Entities,911,105680,1359.0,89246,9.0,3095
2021-05-24 15:00:00,Federal Entities,514,106194,1032.0,90278,8.0,3103
2021-05-25 15:00:00,Federal Entities,5,106199,1.0,90279,2.0,3105
2021-05-27 15:00:00,Federal Entities,425,106624,674.0,90953,1.0,3106
2021-05-28 15:00:00,Federal Entities,418,107042,342.0,91295,,3106
2021-05-29 15:00:00,Federal Entities,267,107309,344.0,91639,10.0,3116
2021-05-31 15:00:00,Federal Entities,214,107523,243.0,91882,3.0,3119
2021-06-01 15:00:00,Federal Entities,30,107553,48.0,91930,,3119
2021-06-16 15:00:00,Federal Entities,2042,109595,3555.0,95485,37.0,3156
2021-06-17 15:00:00,Federal Entities,22,109617,95.0,95580,,3156
2021-06-18 15:00:00,Federal Entities,269,109886,456.0,96036,4.0,3160
2021-06-19 15:00:00,Federal Entities,166,110052,338.0,96374,1.0,3161
2021-06-20 15:00:00,Federal Entities,161,110213,284.0,96658,1.0,3162
2021-06-21 15:00:00,Federal Entities,56,110269,120.0,96778,1.0,3163
2021-06-22 15:00:00,Federal Entities,13,110282,8.0,96786,1.0,3164
2021-06-23 15:00:00,Federal Entities,2,110284,2.0,96788,,3164
2021-06-24 15:00:00,Federal Entities,304,110588,355.0,97143,5.0,3169
2021-06-25 15:00:00,Federal Entities,124,110712,209.0,97352,1.0,3170
2021-06-27 15:00:00,Federal Entities,124,110836,173.0,97525,2.0,3172
2021-06-28 15:00:00,Federal Entities,146,110982,186.0,97711,4.0,3176
2021-06-29 15:00:00,Federal Entities,2,110984,2.0,97713,1.0,3177
2021-07-01 15:00:00,Federal Entities,313,111297,340.0,98053,8.0,3185
2021-07-02 15:00:00,Federal Entities,209,111506,249.0,98302,6.0,3191
2021-07-03 15:00:00,Federal Entities,97,111603,123.0,98425,4.0,3195
2021-07-04 15:00:00,Federal Entities,75,111678,98.0,98523,6.0,3201
2021-07-05 15:00:00,Federal Entities,7,111685,8.0,98531,,3201
2021-02-08 15:00:00,Unknown,777,29099,307.0,15250,,0
2021-02-09 15:00:00,Unknown,766,29865,345.0,15595,,0
2021-02-10 15:00:00,Unknown,793,30658,459.0,16054,,0
2021-02-11 15:00:00,Unknown,855,31513,451.0,16505,,0
2021-02-12 15:00:00,Unknown,737,32250,593.0,17098,,0
2021-02-13 15:00:00,Unknown,403,32653,177.0,17275,,0
2021-02-14 15:00:00,Unknown,430,33083,120.0,17395,,0
2021-02-15 15:00:00,Unknown,443,33526,535.0,17930,,0
2021-02-16 15:00:00,Unknown,703,34229,810.0,18740,,0
2021-02-17 15:00:00,Unknown,787,35016,617.0,19357,,0
2021-02-18 15:00:00,Unknown,253,35269,270.0,19627,,0
2021-02-19 15:00:00,Unknown,502,35771,545.0,20172,,0
2021-02-20 15:00:00,Unknown,573,36344,581.0,20753,,0
2021-02-21 15:00:00,Unknown,339,36683,396.0,21149,,0
2021-02-22 15:00:00,Unknown,439,37122,524.0,21673,,0
2021-02-23 15:00:00,Unknown,662,37784,513.0,22186,,0
2021-02-24 15:00:00,Unknown,614,38398,598.0,22784,,0
2021-02-25 15:00:00,Unknown,616,39014,844.0,23628,,0
2021-02-26 15:00:00,Unknown,756,39770,840.0,24468,,0
2021-02-27 15:00:00,Unknown,563,40333,441.0,24909,,0
2021-02-28 15:00:00,Unknown,611,40944,226.0,25135,,0
2021-03-01 15:00:00,Unknown,863,41807,553.0,25688,,0
2021-03-02 15:00:00,Unknown,788,42595,565.0,26253,1.0,1
2021-03-03 15:00:00,Unknown,990,43585,599.0,26852,3.0,4
2021-03-04 15:00:00,Unknown,963,44548,674.0,27526,100.0,104
2021-03-05 15:00:00,Unknown,1015,45563,572.0,28098,87.0,191
2021-03-06 15:00:00,Unknown,637,46200,302.0,28400,189.0,380
2021-03-07 15:00:00,Unknown,515,46715,330.0,28730,285.0,665
2021-03-08 15:00:00,Unknown,972,47687,346.0,29076,355.0,1020
2021-03-09 15:00:00,Unknown,938,48625,453.0,29529,365.0,1385
2021-03-10 15:00:00,Unknown,874,49499,482.0,30011,484.0,1869
2021-03-11 15:00:00,Unknown,1305,50804,505.0,30516,206.0,2075
2021-03-12 15:00:00,Unknown,1248,52052,601.0,31117,162.0,2237
2021-03-13 15:00:00,Unknown,837,52889,359.0,31476,75.0,2312
2021-03-14 15:00:00,Unknown,1005,53894,342.0,31818,66.0,2378
2021-03-15 15:00:00,Unknown,1669,55563,417.0,32235,37.0,2415
2021-03-16 15:00:00,Unknown,1629,57192,605.0,32840,41.0,2456
2021-03-17 15:00:00,Unknown,1649,58841,680.0,33520,65.0,2521
2021-03-18 15:00:00,Unknown,1776,60617,480.0,34000,60.0,2581
2021-03-19 15:00:00,Unknown,1467,62084,483.0,34483,59.0,2640
2021-03-20 15:00:00,Unknown,1250,63334,431.0,34914,155.0,2795
2021-03-21 15:00:00,Unknown,1063,64397,476.0,35390,24.0,2819
2021-03-22 15:00:00,Unknown,1557,65954,535.0,35925,32.0,2851
2021-03-23 15:00:00,Unknown,1940,67894,645.0,36570,72.0,2923
2021-03-24 15:00:00,Unknown,2574,70468,548.0,37118,73.0,2996
2021-03-25 15:00:00,Unknown,2609,73077,617.0,37735,325.0,3321
2021-03-26 15:00:00,Unknown,2562,75639,721.0,38456,351.0,3672
2021-03-27 15:00:00,Unknown,2092,77731,521.0,38977,496.0,4168
2021-03-28 15:00:00,Unknown,1864,79595,492.0,39469,414.0,4582
2021-03-29 15:00:00,Unknown,2611,82206,1003.0,40472,74.0,4656
2021-03-30 15:00:00,Unknown,2464,84670,1035.0,41507,126.0,4782
2021-03-31 15:00:00,Unknown,2467,87137,926.0,42433,782.0,5564
2021-04-01 15:00:00,Unknown,1574,88711,1305.0,43738,620.0,6184
2021-07-06 15:00:00,Federal Entities,18,111703,22.0,98553,4.0,3205
2021-07-08 15:00:00,Federal Entities,105,111808,155.0,98708,5.0,3210
2021-07-09 15:00:00,Federal Entities,136,111944,203.0,98911,9.0,3219
2021-07-10 15:00:00,Federal Entities,130,112074,140.0,99051,4.0,3223
2021-07-11 15:00:00,Federal Entities,145,112219,137.0,99188,4.0,3227
2021-07-13 15:00:00,Federal Entities,3,112222,1.0,99189,,3227
2020-12-15 15:00:00,Hispanic or Latino,4,4,,0,,0
2020-12-16 15:00:00,Hispanic or Latino,19,23,,0,,0
2020-12-17 15:00:00,Hispanic or Latino,38,61,,0,,0
2020-12-18 15:00:00,Hispanic or Latino,85,146,,0,,0
2020-12-19 15:00:00,Hispanic or Latino,36,182,,0,,0
2020-12-20 15:00:00,Hispanic or Latino,10,192,,0,,0
2020-12-21 15:00:00,Hispanic or Latino,146,338,1.0,1,,0
2020-12-22 15:00:00,Hispanic or Latino,257,595,,1,,0
2020-12-23 15:00:00,Hispanic or Latino,188,783,1.0,2,,0
2020-12-24 15:00:00,Hispanic or Latino,92,875,,2,,0
2020-12-25 15:00:00,Hispanic or Latino,39,914,,2,,0
2020-12-26 15:00:00,Hispanic or Latino,46,960,,2,,0
2020-12-27 15:00:00,Hispanic or Latino,60,1020,,2,,0
2020-12-28 15:00:00,Hispanic or Latino,264,1284,1.0,3,,0
2020-12-29 15:00:00,Hispanic or Latino,367,1651,2.0,5,,0
2020-12-30 15:00:00,Hispanic or Latino,505,2156,2.0,7,,0
2020-12-31 15:00:00,Hispanic or Latino,329,2485,2.0,9,,0
2021-01-01 15:00:00,Hispanic or Latino,67,2552,6.0,15,,0
2021-01-02 15:00:00,Hispanic or Latino,91,2643,2.0,17,,0
2021-01-03 15:00:00,Hispanic or Latino,124,2767,3.0,20,,0
2021-01-04 15:00:00,Hispanic or Latino,620,3387,12.0,32,,0
2021-01-05 15:00:00,Hispanic or Latino,413,3800,19.0,51,,0
2021-01-06 15:00:00,Hispanic or Latino,603,4403,21.0,72,,0
2021-01-07 15:00:00,Hispanic or Latino,808,5211,61.0,133,,0
2021-01-08 15:00:00,Hispanic or Latino,874,6085,92.0,225,,0
2021-01-09 15:00:00,Hispanic or Latino,195,6280,34.0,259,,0
2021-01-10 15:00:00,Hispanic or Latino,137,6417,22.0,281,,0
2021-01-11 15:00:00,Hispanic or Latino,552,6969,129.0,410,,0
2021-01-12 15:00:00,Hispanic or Latino,738,7707,208.0,618,,0
2021-01-13 15:00:00,Hispanic or Latino,678,8385,132.0,750,,0
2021-01-14 15:00:00,Hispanic or Latino,749,9134,69.0,819,,0
2021-01-15 15:00:00,Hispanic or Latino,882,10016,69.0,888,,0
2021-01-16 15:00:00,Hispanic or Latino,184,10200,42.0,930,,0
2021-01-17 15:00:00,Hispanic or Latino,98,10298,46.0,976,,0
2021-01-18 15:00:00,Hispanic or Latino,164,10462,118.0,1094,,0
2021-01-19 15:00:00,Hispanic or Latino,481,10943,161.0,1255,,0
2021-01-20 15:00:00,Hispanic or Latino,628,11571,188.0,1443,,0
2021-01-21 15:00:00,Hispanic or Latino,760,12331,123.0,1566,,0
2021-01-22 15:00:00,Hispanic or Latino,972,13303,108.0,1674,,0
2021-01-23 15:00:00,Hispanic or Latino,320,13623,69.0,1743,,0
2021-01-24 15:00:00,Hispanic or Latino,88,13711,45.0,1788,,0
2021-01-25 15:00:00,Hispanic or Latino,371,14082,314.0,2102,,0
2021-01-26 15:00:00,Hispanic or Latino,480,14562,238.0,2340,,0
2021-01-27 15:00:00,Hispanic or Latino,753,15315,439.0,2779,,0
2021-01-28 15:00:00,Hispanic or Latino,803,16118,400.0,3179,,0
2021-01-29 15:00:00,Hispanic or Latino,734,16852,304.0,3483,,0
2021-01-30 15:00:00,Hispanic or Latino,508,17360,93.0,3576,,0
2021-01-31 15:00:00,Hispanic or Latino,138,17498,30.0,3606,,0
2021-02-01 15:00:00,Hispanic or Latino,178,17676,162.0,3768,,0
2021-02-02 15:00:00,Hispanic or Latino,419,18095,599.0,4367,,0
2021-02-03 15:00:00,Hispanic or Latino,619,18714,668.0,5035,,0
2021-02-04 15:00:00,Hispanic or Latino,748,19462,720.0,5755,,0
2021-02-05 15:00:00,Hispanic or Latino,775,20237,873.0,6628,,0
2021-02-06 15:00:00,Hispanic or Latino,399,20636,206.0,6834,,0
2021-02-07 15:00:00,Hispanic or Latino,164,20800,65.0,6899,,0
2021-02-08 15:00:00,Hispanic or Latino,548,21348,618.0,7517,,0
2021-02-09 15:00:00,Hispanic or Latino,551,21899,527.0,8044,,0
2021-04-02 15:00:00,Unknown,1850,90561,1356.0,45094,728.0,6912
2021-04-03 15:00:00,Unknown,1630,92191,835.0,45929,651.0,7563
2021-04-04 15:00:00,Unknown,596,92787,646.0,46575,47.0,7610
2021-04-05 15:00:00,Unknown,1863,94650,1170.0,47745,658.0,8268
2021-04-06 15:00:00,Unknown,2197,96847,1277.0,49022,863.0,9131
2021-04-07 15:00:00,Unknown,2446,99293,1365.0,50387,1307.0,10438
2021-04-08 15:00:00,Unknown,3067,102360,1510.0,51897,1481.0,11919
2021-04-09 15:00:00,Unknown,3323,105683,1085.0,52982,1253.0,13172
2021-04-10 15:00:00,Unknown,2935,108618,1031.0,54013,964.0,14136
2021-04-11 15:00:00,Unknown,2458,111076,1048.0,55061,1026.0,15162
2021-04-12 15:00:00,Unknown,2763,113839,1847.0,56908,1066.0,16228
2021-04-13 15:00:00,Unknown,3280,117119,1919.0,58827,34.0,16262
2021-04-14 15:00:00,Unknown,3131,120250,2167.0,60994,10.0,16272
2021-04-15 15:00:00,Unknown,3778,124028,2335.0,63329,14.0,16286
2021-04-16 15:00:00,Unknown,3391,127419,2364.0,65693,2.0,16288
2021-04-17 15:00:00,Unknown,3680,131099,1611.0,67304,1.0,16289
2021-04-18 15:00:00,Unknown,2887,133986,1657.0,68961,,16289
2021-04-19 15:00:00,Unknown,2757,136743,2420.0,71381,2.0,16291
2021-04-20 15:00:00,Unknown,2241,138984,2146.0,73527,,16291
2021-04-21 15:00:00,Unknown,3045,142029,2517.0,76044,,16291
2021-04-22 15:00:00,Unknown,2707,144736,1307.0,77351,,16291
2021-04-23 15:00:00,Unknown,3172,147908,1990.0,79341,2.0,16293
2021-04-24 15:00:00,Unknown,3062,150970,1780.0,81121,3.0,16296
2021-04-25 15:00:00,Unknown,2350,153320,758.0,81879,,16296
2021-04-26 15:00:00,Unknown,1770,155090,1586.0,83465,11.0,16307
2021-04-27 15:00:00,Unknown,2297,157387,1492.0,84957,81.0,16388
2021-04-28 15:00:00,Unknown,2084,159471,2569.0,87526,94.0,16482
2021-04-29 15:00:00,Unknown,1832,161303,2732.0,90258,83.0,16565
2021-04-30 15:00:00,Unknown,1986,163289,2790.0,93048,108.0,16673
2021-05-01 15:00:00,Unknown,1567,164856,2752.0,95800,57.0,16730
2021-05-02 15:00:00,Unknown,1187,166043,2221.0,98021,34.0,16764
2021-05-03 15:00:00,Unknown,778,166821,2780.0,100801,87.0,16851
2021-05-04 15:00:00,Unknown,765,167586,3048.0,103849,102.0,16953
2021-05-05 15:00:00,Unknown,1394,168980,2976.0,106825,114.0,17067
2021-05-06 15:00:00,Unknown,1195,170175,3299.0,110124,92.0,17159
2021-05-07 15:00:00,Unknown,1260,171435,2929.0,113053,108.0,17267
2021-05-08 15:00:00,Unknown,1014,172449,3159.0,116212,106.0,17373
2021-05-09 15:00:00,Unknown,683,173132,1523.0,117735,36.0,17409
2021-05-10 15:00:00,Unknown,626,173758,2892.0,120627,81.0,17490
2021-05-11 15:00:00,Unknown,745,174503,2349.0,122976,85.0,17575
2021-05-12 15:00:00,Unknown,879,175382,2746.0,125722,160.0,17735
2021-05-13 15:00:00,Unknown,1076,176458,2324.0,128046,141.0,17876
2021-05-14 15:00:00,Unknown,1196,177654,2396.0,130442,186.0,18062
2021-05-15 15:00:00,Unknown,1423,179077,2449.0,132891,248.0,18310
2021-05-16 15:00:00,Unknown,563,179640,2109.0,135000,198.0,18508
2021-05-17 15:00:00,Unknown,601,180241,1755.0,136755,225.0,18733
2021-05-18 15:00:00,Unknown,1060,181301,2573.0,139328,190.0,18923
2021-05-19 15:00:00,Unknown,1229,182530,2513.0,141841,166.0,19089
2021-05-20 15:00:00,Unknown,1015,183545,2147.0,143988,174.0,19263
2021-05-21 15:00:00,Unknown,1113,184658,2084.0,146072,196.0,19459
2021-05-22 15:00:00,Unknown,1155,185813,1213.0,147285,233.0,19692
2021-05-23 15:00:00,Unknown,657,186470,1283.0,148568,192.0,19884
2021-05-24 15:00:00,Unknown,610,187080,846.0,149414,225.0,20109
2021-05-25 15:00:00,Unknown,782,187862,868.0,150282,140.0,20249
2021-05-26 15:00:00,Unknown,910,188772,1121.0,151403,183.0,20432
2021-05-27 15:00:00,Unknown,637,189409,995.0,152398,138.0,20570
2021-05-28 15:00:00,Unknown,667,190076,1251.0,153649,180.0,20750
2021-05-29 15:00:00,Unknown,733,190809,1237.0,154886,229.0,20979
2021-05-30 15:00:00,Unknown,370,191179,860.0,155746,140.0,21119
2021-05-31 15:00:00,Unknown,67,191246,203.0,155949,73.0,21192
2021-06-01 15:00:00,Unknown,539,191785,926.0,156875,136.0,21328
2021-06-02 15:00:00,Unknown,531,192316,1012.0,157887,84.0,21412
2021-06-03 15:00:00,Unknown,425,192741,1019.0,158906,104.0,21516
2021-06-04 15:00:00,Unknown,444,193185,1121.0,160027,65.0,21581
2021-06-05 15:00:00,Unknown,492,193677,1173.0,161200,48.0,21629
2021-06-06 15:00:00,Unknown,208,193885,481.0,161681,67.0,21696
2021-06-07 15:00:00,Unknown,356,194241,429.0,162110,54.0,21750
2021-06-08 15:00:00,Unknown,370,194611,779.0,162889,82.0,21832
2021-06-09 15:00:00,Unknown,477,195088,937.0,163826,64.0,21896
2021-06-10 15:00:00,Unknown,463,195551,900.0,164726,71.0,21967
2021-06-11 15:00:00,Unknown,516,196067,891.0,165617,107.0,22074
2021-06-12 15:00:00,Unknown,495,196562,1049.0,166666,87.0,22161
2021-06-13 15:00:00,Unknown,234,196796,487.0,167153,55.0,22216
2021-06-14 15:00:00,Unknown,315,197111,397.0,167550,60.0,22276
2021-06-15 15:00:00,Unknown,397,197508,788.0,168338,107.0,22383
2021-06-16 15:00:00,Unknown,339,197847,710.0,169048,72.0,22455
2021-06-17 15:00:00,Unknown,372,198219,538.0,169586,88.0,22543
2021-06-18 15:00:00,Unknown,384,198603,588.0,170174,58.0,22601
2021-06-19 15:00:00,Unknown,300,198903,628.0,170802,49.0,22650
2021-06-20 15:00:00,Unknown,178,199081,251.0,171053,33.0,22683
2021-06-21 15:00:00,Unknown,329,199410,178.0,171231,31.0,22714
2021-06-22 15:00:00,Unknown,414,199824,502.0,171733,93.0,22807
2021-06-23 15:00:00,Unknown,417,200241,453.0,172186,45.0,22852
2021-06-24 15:00:00,Unknown,392,200633,321.0,172507,44.0,22896
2021-06-25 15:00:00,Unknown,402,201035,348.0,172855,52.0,22948
2021-06-26 15:00:00,Unknown,322,201357,378.0,173233,60.0,23008
2021-06-27 15:00:00,Unknown,255,201612,164.0,173397,15.0,23023
2021-06-28 15:00:00,Unknown,457,202069,213.0,173610,33.0,23056
2021-06-29 15:00:00,Unknown,458,202527,318.0,173928,54.0,23110
2021-06-30 15:00:00,Unknown,418,202945,294.0,174222,41.0,23151
2021-07-01 15:00:00,Unknown,380,203325,348.0,174570,50.0,23201
2021-07-02 15:00:00,Unknown,369,203694,343.0,174913,33.0,23234
2021-07-03 15:00:00,Unknown,313,204007,275.0,175188,23.0,23257
2021-07-04 15:00:00,Unknown,31,204038,14.0,175202,1.0,23258
2021-07-05 15:00:00,Unknown,352,204390,203.0,175405,15.0,23273
2021-07-06 15:00:00,Unknown,343,204733,290.0,175695,58.0,23331
2021-07-07 15:00:00,Unknown,352,205085,230.0,175925,28.0,23359
2021-07-08 15:00:00,Unknown,398,205483,209.0,176134,31.0,23390
2021-07-09 15:00:00,Unknown,324,205807,252.0,176386,62.0,23452
2021-07-10 15:00:00,Unknown,320,206127,216.0,176602,34.0,23486
2021-07-11 15:00:00,Unknown,214,206341,178.0,176780,16.0,23502
2021-07-12 15:00:00,Unknown,436,206777,196.0,176976,17.0,23519
2021-07-13 15:00:00,Unknown,217,206994,99.0,177075,24.0,23543
2020-12-14 15:00:00,Not Hispanic or Latino,9,9,,0,,0
2020-12-15 15:00:00,Not Hispanic or Latino,22,31,1.0,1,,0
2020-12-16 15:00:00,Not Hispanic or Latino,531,562,1.0,2,,0
2021-02-10 15:00:00,Hispanic or Latino,699,22598,693.0,8737,,0
2021-02-11 15:00:00,Hispanic or Latino,864,23462,731.0,9468,,0
2021-02-12 15:00:00,Hispanic or Latino,779,24241,859.0,10327,,0
2021-02-13 15:00:00,Hispanic or Latino,370,24611,224.0,10551,,0
2021-02-14 15:00:00,Hispanic or Latino,278,24889,66.0,10617,,0
2021-02-15 15:00:00,Hispanic or Latino,322,25211,361.0,10978,,0
2021-02-16 15:00:00,Hispanic or Latino,519,25730,538.0,11516,,0
2021-02-17 15:00:00,Hispanic or Latino,695,26425,753.0,12269,,0
2021-02-18 15:00:00,Hispanic or Latino,115,26540,133.0,12402,,0
2021-02-19 15:00:00,Hispanic or Latino,364,26904,772.0,13174,,0
2021-02-20 15:00:00,Hispanic or Latino,367,27271,638.0,13812,,0
2021-02-21 15:00:00,Hispanic or Latino,313,27584,249.0,14061,,0
2021-02-22 15:00:00,Hispanic or Latino,288,27872,420.0,14481,,0
2021-02-23 15:00:00,Hispanic or Latino,532,28404,495.0,14976,,0
2021-02-24 15:00:00,Hispanic or Latino,571,28975,825.0,15801,,0
2021-02-25 15:00:00,Hispanic or Latino,783,29758,827.0,16628,,0
2021-02-26 15:00:00,Hispanic or Latino,1136,30894,851.0,17479,,0
2021-02-27 15:00:00,Hispanic or Latino,669,31563,349.0,17828,,0
2021-02-28 15:00:00,Hispanic or Latino,738,32301,183.0,18011,,0
2021-03-01 15:00:00,Hispanic or Latino,1152,33453,428.0,18439,,0
2021-03-02 15:00:00,Hispanic or Latino,1054,34507,357.0,18796,1.0,1
2021-03-03 15:00:00,Hispanic or Latino,1177,35684,664.0,19460,13.0,14
2021-03-04 15:00:00,Hispanic or Latino,1355,37039,506.0,19966,148.0,162
2021-03-05 15:00:00,Hispanic or Latino,1679,38718,611.0,20577,203.0,365
2021-03-06 15:00:00,Hispanic or Latino,900,39618,273.0,20850,381.0,746
2021-03-07 15:00:00,Hispanic or Latino,582,40200,196.0,21046,289.0,1035
2021-03-08 15:00:00,Hispanic or Latino,1225,41425,311.0,21357,365.0,1400
2021-03-09 15:00:00,Hispanic or Latino,1242,42667,469.0,21826,444.0,1844
2021-03-10 15:00:00,Hispanic or Latino,1399,44066,617.0,22443,531.0,2375
2021-03-11 15:00:00,Hispanic or Latino,1683,45749,669.0,23112,255.0,2630
2021-03-12 15:00:00,Hispanic or Latino,2092,47841,671.0,23783,226.0,2856
2021-03-13 15:00:00,Hispanic or Latino,1213,49054,391.0,24174,213.0,3069
2021-03-14 15:00:00,Hispanic or Latino,1544,50598,219.0,24393,109.0,3178
2021-03-15 15:00:00,Hispanic or Latino,1789,52387,348.0,24741,44.0,3222
2021-03-16 15:00:00,Hispanic or Latino,2072,54459,436.0,25177,20.0,3242
2021-03-17 15:00:00,Hispanic or Latino,2495,56954,602.0,25779,59.0,3301
2021-03-18 15:00:00,Hispanic or Latino,2627,59581,404.0,26183,97.0,3398
2021-03-19 15:00:00,Hispanic or Latino,2627,62208,548.0,26731,82.0,3480
2021-03-20 15:00:00,Hispanic or Latino,2144,64352,427.0,27158,50.0,3530
2021-03-21 15:00:00,Hispanic or Latino,1623,65975,456.0,27614,15.0,3545
2021-03-22 15:00:00,Hispanic or Latino,2257,68232,445.0,28059,32.0,3577
2021-03-23 15:00:00,Hispanic or Latino,2666,70898,625.0,28684,131.0,3708
2021-03-24 15:00:00,Hispanic or Latino,3214,74112,829.0,29513,207.0,3915
2021-03-25 15:00:00,Hispanic or Latino,3363,77475,856.0,30369,113.0,4028
2021-03-26 15:00:00,Hispanic or Latino,2527,80002,1271.0,31640,198.0,4226
2021-03-27 15:00:00,Hispanic or Latino,2241,82243,813.0,32453,152.0,4378
2021-03-28 15:00:00,Hispanic or Latino,1121,83364,548.0,33001,72.0,4450
2021-03-29 15:00:00,Hispanic or Latino,2018,85382,1264.0,34265,60.0,4510
2021-03-30 15:00:00,Hispanic or Latino,2761,88143,1204.0,35469,108.0,4618
2021-03-31 15:00:00,Hispanic or Latino,3439,91582,1363.0,36832,387.0,5005
2021-04-01 15:00:00,Hispanic or Latino,2786,94368,1795.0,38627,301.0,5306
2021-04-02 15:00:00,Hispanic or Latino,2759,97127,1909.0,40536,330.0,5636
2021-04-03 15:00:00,Hispanic or Latino,2115,99242,1002.0,41538,285.0,5921
2021-04-04 15:00:00,Hispanic or Latino,691,99933,573.0,42111,49.0,5970
2021-04-05 15:00:00,Hispanic or Latino,2324,102257,1525.0,43636,360.0,6330
2021-04-06 15:00:00,Hispanic or Latino,3124,105381,1805.0,45441,514.0,6844
2021-04-07 15:00:00,Hispanic or Latino,3543,108924,1774.0,47215,872.0,7716
2021-04-08 15:00:00,Hispanic or Latino,3345,112269,1925.0,49140,1205.0,8921
2021-04-09 15:00:00,Hispanic or Latino,3270,115539,2214.0,51354,1108.0,10029
2021-04-10 15:00:00,Hispanic or Latino,2235,117774,1569.0,52923,612.0,10641
2021-04-11 15:00:00,Hispanic or Latino,2165,119939,1333.0,54256,664.0,11305
2021-04-12 15:00:00,Hispanic or Latino,2196,122135,2137.0,56393,781.0,12086
2020-12-17 15:00:00,Not Hispanic or Latino,1038,1600,1.0,3,,0
2020-12-18 15:00:00,Not Hispanic or Latino,2757,4357,3.0,6,,0
2020-12-19 15:00:00,Not Hispanic or Latino,825,5182,2.0,8,,0
2020-12-20 15:00:00,Not Hispanic or Latino,258,5440,3.0,11,,0
2020-12-21 15:00:00,Not Hispanic or Latino,3570,9010,6.0,17,,0
2020-12-22 15:00:00,Not Hispanic or Latino,5604,14614,7.0,24,,0
2020-12-23 15:00:00,Not Hispanic or Latino,5270,19884,14.0,38,,0
2020-12-24 15:00:00,Not Hispanic or Latino,2515,22399,6.0,44,,0
2020-12-25 15:00:00,Not Hispanic or Latino,812,23211,2.0,46,,0
2020-12-26 15:00:00,Not Hispanic or Latino,1593,24804,4.0,50,,0
2020-12-27 15:00:00,Not Hispanic or Latino,1577,26381,6.0,56,,0
2020-12-28 15:00:00,Not Hispanic or Latino,8305,34686,17.0,73,,0
2020-12-29 15:00:00,Not Hispanic or Latino,9982,44668,11.0,84,,0
2020-12-30 15:00:00,Not Hispanic or Latino,11491,56159,32.0,116,,0
2020-12-31 15:00:00,Not Hispanic or Latino,6913,63072,15.0,131,,0
2021-01-01 15:00:00,Not Hispanic or Latino,1716,64788,45.0,176,,0
2021-01-02 15:00:00,Not Hispanic or Latino,2629,67417,23.0,199,,0
2021-01-03 15:00:00,Not Hispanic or Latino,2966,70383,65.0,264,,0
2021-01-04 15:00:00,Not Hispanic or Latino,11907,82290,261.0,525,,0
2021-01-05 15:00:00,Not Hispanic or Latino,11332,93622,433.0,958,,0
2021-01-06 15:00:00,Not Hispanic or Latino,13755,107377,754.0,1712,,0
2021-01-07 15:00:00,Not Hispanic or Latino,13604,120981,1525.0,3237,,0
2021-01-08 15:00:00,Not Hispanic or Latino,14616,135597,2479.0,5716,,0
2021-01-09 15:00:00,Not Hispanic or Latino,4615,140212,829.0,6545,,0
2021-01-10 15:00:00,Not Hispanic or Latino,2523,142735,323.0,6868,,0
2021-01-11 15:00:00,Not Hispanic or Latino,12663,155398,3115.0,9983,,0
2021-01-12 15:00:00,Not Hispanic or Latino,15685,171083,4946.0,14929,,0
2021-01-13 15:00:00,Not Hispanic or Latino,17251,188334,3511.0,18440,,0
2021-01-14 15:00:00,Not Hispanic or Latino,16494,204828,1734.0,20174,,0
2021-01-15 15:00:00,Not Hispanic or Latino,17807,222635,1614.0,21788,,0
2021-01-16 15:00:00,Not Hispanic or Latino,5158,227793,1352.0,23140,,0
2021-01-17 15:00:00,Not Hispanic or Latino,1830,229623,1314.0,24454,,0
2021-01-18 15:00:00,Not Hispanic or Latino,6619,236242,2870.0,27324,,0
2021-01-19 15:00:00,Not Hispanic or Latino,16202,252444,4788.0,32112,,0
2021-01-20 15:00:00,Not Hispanic or Latino,20066,272510,4746.0,36858,,0
2021-01-21 15:00:00,Not Hispanic or Latino,22373,294883,3326.0,40184,,0
2021-01-22 15:00:00,Not Hispanic or Latino,26995,321878,3181.0,43365,,0
2021-01-23 15:00:00,Not Hispanic or Latino,9131,331009,1612.0,44977,,0
2021-01-24 15:00:00,Not Hispanic or Latino,2971,333980,1486.0,46463,,0
2021-01-25 15:00:00,Not Hispanic or Latino,15536,349516,7584.0,54047,,0
2021-01-26 15:00:00,Not Hispanic or Latino,16614,366130,8162.0,62209,,0
2021-01-27 15:00:00,Not Hispanic or Latino,23599,389729,11258.0,73467,,0
2021-01-28 15:00:00,Not Hispanic or Latino,21812,411541,8394.0,81861,,0
2021-01-29 15:00:00,Not Hispanic or Latino,24025,435566,7124.0,88985,,0
2021-01-30 15:00:00,Not Hispanic or Latino,17330,452896,2240.0,91225,,0
2021-01-31 15:00:00,Not Hispanic or Latino,3497,456393,1134.0,92359,,0
2021-02-01 15:00:00,Not Hispanic or Latino,6469,462862,4237.0,96596,,0
2021-02-02 15:00:00,Not Hispanic or Latino,11564,474426,12280.0,108876,,0
2021-02-03 15:00:00,Not Hispanic or Latino,17126,491552,16768.0,125644,,0
2021-02-04 15:00:00,Not Hispanic or Latino,20693,512245,14347.0,139991,,0
2021-02-05 15:00:00,Not Hispanic or Latino,18901,531146,15890.0,155881,,0
2021-02-06 15:00:00,Not Hispanic or Latino,11036,542182,5857.0,161738,,0
2021-02-07 15:00:00,Not Hispanic or Latino,5365,547547,1553.0,163291,,0
2021-02-08 15:00:00,Not Hispanic or Latino,11862,559409,11994.0,175285,,0
2021-02-09 15:00:00,Not Hispanic or Latino,15247,574656,12968.0,188253,,0
2021-02-10 15:00:00,Not Hispanic or Latino,17652,592308,20052.0,208305,,0
2021-02-11 15:00:00,Not Hispanic or Latino,21053,613361,16132.0,224437,,0
2021-02-12 15:00:00,Not Hispanic or Latino,18752,632113,18201.0,242638,,0
2021-02-13 15:00:00,Not Hispanic or Latino,10549,642662,5820.0,248458,,0
2021-02-14 15:00:00,Not Hispanic or Latino,6329,648991,1821.0,250279,,0
2021-02-15 15:00:00,Not Hispanic or Latino,10856,659847,12162.0,262441,,0
2021-02-16 15:00:00,Not Hispanic or Latino,15259,675106,20172.0,282613,,0
2021-02-17 15:00:00,Not Hispanic or Latino,19044,694150,25566.0,308179,,0
2021-02-18 15:00:00,Not Hispanic or Latino,2756,696906,4239.0,312418,,0
2021-02-19 15:00:00,Not Hispanic or Latino,9341,706247,18943.0,331361,,0
2021-02-20 15:00:00,Not Hispanic or Latino,9332,715579,19458.0,350819,,0
2021-02-21 15:00:00,Not Hispanic or Latino,5433,721012,7183.0,358002,,0
2021-02-22 15:00:00,Not Hispanic or Latino,7292,728304,14773.0,372775,,0
2021-02-23 15:00:00,Not Hispanic or Latino,14317,742621,15297.0,388072,,0
2021-02-24 15:00:00,Not Hispanic or Latino,16712,759333,23579.0,411651,,0
2021-02-25 15:00:00,Not Hispanic or Latino,18927,778260,25052.0,436703,,0
2021-02-26 15:00:00,Not Hispanic or Latino,24821,803081,24515.0,461218,,0
2021-02-27 15:00:00,Not Hispanic or Latino,14773,817854,10808.0,472026,,0
2021-02-28 15:00:00,Not Hispanic or Latino,14070,831924,4306.0,476332,,0
2021-03-01 15:00:00,Not Hispanic or Latino,22886,854810,11096.0,487428,,0
2021-03-02 15:00:00,Not Hispanic or Latino,21920,876730,12224.0,499652,22.0,22
2021-03-03 15:00:00,Not Hispanic or Latino,27749,904479,16859.0,516511,140.0,162
2021-03-04 15:00:00,Not Hispanic or Latino,28562,933041,16750.0,533261,3815.0,3977
2021-03-05 15:00:00,Not Hispanic or Latino,26651,959692,17937.0,551198,4604.0,8581
2021-03-06 15:00:00,Not Hispanic or Latino,16113,975805,8208.0,559406,5397.0,13978
2021-03-07 15:00:00,Not Hispanic or Latino,10900,986705,4216.0,563622,5990.0,19968
2021-03-08 15:00:00,Not Hispanic or Latino,23811,1010516,7922.0,571544,7545.0,27513
2021-03-09 15:00:00,Not Hispanic or Latino,24062,1034578,14249.0,585793,7507.0,35020
2021-03-10 15:00:00,Not Hispanic or Latino,27663,1062241,14594.0,600387,6911.0,41931
2021-03-11 15:00:00,Not Hispanic or Latino,33059,1095300,15029.0,615416,3563.0,45494
2021-03-12 15:00:00,Not Hispanic or Latino,33641,1128941,16558.0,631974,2518.0,48012
2021-03-13 15:00:00,Not Hispanic or Latino,20393,1149334,9350.0,641324,1289.0,49301
2021-03-14 15:00:00,Not Hispanic or Latino,15222,1164556,6001.0,647325,803.0,50104
2021-03-15 15:00:00,Not Hispanic or Latino,26276,1190832,10360.0,657685,498.0,50602
2021-03-16 15:00:00,Not Hispanic or Latino,29737,1220569,12279.0,669964,703.0,51305
2021-03-17 15:00:00,Not Hispanic or Latino,33376,1253945,15453.0,685417,1042.0,52347
2021-03-18 15:00:00,Not Hispanic or Latino,36902,1290847,11508.0,696925,1192.0,53539
2021-03-19 15:00:00,Not Hispanic or Latino,33847,1324694,14302.0,711227,897.0,54436
2021-03-20 15:00:00,Not Hispanic or Latino,20924,1345618,8980.0,720207,911.0,55347
2021-03-21 15:00:00,Not Hispanic or Latino,16296,1361914,6744.0,726951,280.0,55627
2021-03-22 15:00:00,Not Hispanic or Latino,28686,1390600,10397.0,737348,762.0,56389
2021-03-23 15:00:00,Not Hispanic or Latino,33037,1423637,15957.0,753305,1330.0,57719
2021-03-24 15:00:00,Not Hispanic or Latino,35211,1458848,19491.0,772796,1086.0,58805
2021-03-25 15:00:00,Not Hispanic or Latino,36333,1495181,19283.0,792079,2072.0,60877
2021-03-26 15:00:00,Not Hispanic or Latino,31334,1526515,24067.0,816146,1948.0,62825
2021-03-27 15:00:00,Not Hispanic or Latino,23427,1549942,15377.0,831523,2070.0,64895
2021-03-28 15:00:00,Not Hispanic or Latino,13968,1563910,11425.0,842948,1127.0,66022
2021-03-29 15:00:00,Not Hispanic or Latino,25080,1588990,23987.0,866935,996.0,67018
2021-03-30 15:00:00,Not Hispanic or Latino,34690,1623680,26649.0,893584,1605.0,68623
2021-03-31 15:00:00,Not Hispanic or Latino,35008,1658688,32246.0,925830,4563.0,73186
2021-04-01 15:00:00,Not Hispanic or Latino,35279,1693967,35899.0,961729,4606.0,77792
2021-04-02 15:00:00,Not Hispanic or Latino,30077,1724044,29119.0,990848,4865.0,82657
2021-04-03 15:00:00,Not Hispanic or Latino,17750,1741794,16564.0,1007412,3481.0,86138
2021-04-04 15:00:00,Not Hispanic or Latino,6946,1748740,8861.0,1016273,851.0,86989
2021-04-05 15:00:00,Not Hispanic or Latino,23674,1772414,26056.0,1042329,5599.0,92588
2021-04-06 15:00:00,Not Hispanic or Latino,34500,1806914,27198.0,1069527,9088.0,101676
2021-04-07 15:00:00,Not Hispanic or Latino,30016,1836930,30767.0,1100294,10728.0,112404
2021-04-08 15:00:00,Not Hispanic or Latino,35861,1872791,32355.0,1132649,11147.0,123551
2021-04-09 15:00:00,Not Hispanic or Latino,27487,1900278,32683.0,1165332,12100.0,135651
2021-04-10 15:00:00,Not Hispanic or Latino,18778,1919056,20183.0,1185515,6029.0,141680
2021-04-11 15:00:00,Not Hispanic or Latino,12924,1931980,10792.0,1196307,8909.0,150589
2021-04-12 15:00:00,Not Hispanic or Latino,19706,1951686,28945.0,1225252,9079.0,159668
2021-04-13 15:00:00,Hispanic or Latino,3646,125781,2528.0,58921,29.0,12115
2021-04-14 15:00:00,Hispanic or Latino,4453,130234,2594.0,61515,34.0,12149
2021-04-15 15:00:00,Hispanic or Latino,3701,133935,2276.0,63791,24.0,12173
2021-04-16 15:00:00,Hispanic or Latino,3730,137665,2804.0,66595,,12173
2021-04-17 15:00:00,Hispanic or Latino,3687,141352,1848.0,68443,,12173
2021-04-18 15:00:00,Hispanic or Latino,2414,143766,1204.0,69647,,12173
2021-04-19 15:00:00,Hispanic or Latino,3407,147173,1924.0,71571,6.0,12179
2021-04-20 15:00:00,Hispanic or Latino,3639,150812,2506.0,74077,,12179
2021-04-21 15:00:00,Hispanic or Latino,5177,155989,3305.0,77382,1.0,12180
2021-04-22 15:00:00,Hispanic or Latino,4020,160009,3254.0,80636,,12180
2021-04-23 15:00:00,Hispanic or Latino,3775,163784,3077.0,83713,,12180
2021-04-24 15:00:00,Hispanic or Latino,4354,168138,2584.0,86297,8.0,12188
2021-04-25 15:00:00,Hispanic or Latino,2903,171041,819.0,87116,3.0,12191
2021-04-26 15:00:00,Hispanic or Latino,3624,174665,2439.0,89555,16.0,12207
2021-04-27 15:00:00,Hispanic or Latino,3579,178244,2595.0,92150,112.0,12319
2021-04-28 15:00:00,Hispanic or Latino,3727,181971,3683.0,95833,143.0,12462
2021-04-29 15:00:00,Hispanic or Latino,3669,185640,3124.0,98957,159.0,12621
2021-04-30 15:00:00,Hispanic or Latino,4197,189837,2752.0,101709,175.0,12796
2021-05-01 15:00:00,Hispanic or Latino,3458,193295,2304.0,104013,133.0,12929
2021-05-02 15:00:00,Hispanic or Latino,1626,194921,1624.0,105637,128.0,13057
2021-05-03 15:00:00,Hispanic or Latino,1948,196869,2210.0,107847,235.0,13292
2021-05-04 15:00:00,Hispanic or Latino,1942,198811,3200.0,111047,176.0,13468
2021-05-05 15:00:00,Hispanic or Latino,2943,201754,3866.0,114913,222.0,13690
2021-05-06 15:00:00,Hispanic or Latino,2208,203962,3459.0,118372,164.0,13854
2021-05-07 15:00:00,Hispanic or Latino,3030,206992,3666.0,122038,190.0,14044
2021-05-08 15:00:00,Hispanic or Latino,2043,209035,3223.0,125261,174.0,14218
2021-05-09 15:00:00,Hispanic or Latino,961,209996,1481.0,126742,103.0,14321
2021-05-10 15:00:00,Hispanic or Latino,1317,211313,3104.0,129846,141.0,14462
2021-05-11 15:00:00,Hispanic or Latino,1832,213145,3121.0,132967,155.0,14617
2021-05-12 15:00:00,Hispanic or Latino,2254,215399,4311.0,137278,337.0,14954
2021-05-13 15:00:00,Hispanic or Latino,2531,217930,3484.0,140762,119.0,15073
2021-05-14 15:00:00,Hispanic or Latino,3370,221300,2959.0,143721,185.0,15258
2021-05-15 15:00:00,Hispanic or Latino,3396,224696,3405.0,147126,234.0,15492
2021-05-16 15:00:00,Hispanic or Latino,1407,226103,2319.0,149445,200.0,15692
2021-05-17 15:00:00,Hispanic or Latino,1947,228050,3140.0,152585,197.0,15889
2021-05-18 15:00:00,Hispanic or Latino,2875,230925,3771.0,156356,232.0,16121
2021-05-19 15:00:00,Hispanic or Latino,4087,235012,4014.0,160370,235.0,16356
2021-05-20 15:00:00,Hispanic or Latino,3073,238085,3912.0,164282,225.0,16581
2021-05-21 15:00:00,Hispanic or Latino,2955,241040,4194.0,168476,222.0,16803
2021-05-22 15:00:00,Hispanic or Latino,3257,244297,3414.0,171890,245.0,17048
2021-05-23 15:00:00,Hispanic or Latino,1791,246088,2003.0,173893,169.0,17217
2021-05-24 15:00:00,Hispanic or Latino,2017,248105,2425.0,176318,179.0,17396
2021-05-25 15:00:00,Hispanic or Latino,2166,250271,2469.0,178787,158.0,17554
2021-05-26 15:00:00,Hispanic or Latino,2787,253058,2892.0,181679,159.0,17713
2021-05-27 15:00:00,Hispanic or Latino,1719,254777,2372.0,184051,123.0,17836
2021-05-28 15:00:00,Hispanic or Latino,2168,256945,3111.0,187162,194.0,18030
2021-05-29 15:00:00,Hispanic or Latino,2410,259355,2241.0,189403,145.0,18175
2021-05-30 15:00:00,Hispanic or Latino,1152,260507,1068.0,190471,105.0,18280
2021-05-31 15:00:00,Hispanic or Latino,301,260808,541.0,191012,43.0,18323
2021-06-01 15:00:00,Hispanic or Latino,1739,262547,2183.0,193195,155.0,18478
2021-06-02 15:00:00,Hispanic or Latino,2025,264572,2136.0,195331,123.0,18601
2021-06-03 15:00:00,Hispanic or Latino,1479,266051,2202.0,197533,122.0,18723
2021-06-04 15:00:00,Hispanic or Latino,1534,267585,3209.0,200742,131.0,18854
2021-06-05 15:00:00,Hispanic or Latino,1608,269193,2670.0,203412,122.0,18976
2021-06-06 15:00:00,Hispanic or Latino,990,270183,858.0,204270,87.0,19063
2021-06-07 15:00:00,Hispanic or Latino,1420,271603,1755.0,206025,102.0,19165
2021-06-08 15:00:00,Hispanic or Latino,1301,272904,2554.0,208579,116.0,19281
2021-06-09 15:00:00,Hispanic or Latino,1939,274843,3580.0,212159,141.0,19422
2021-06-10 15:00:00,Hispanic or Latino,1351,276194,2971.0,215130,110.0,19532
2021-06-11 15:00:00,Hispanic or Latino,1635,277829,2692.0,217822,188.0,19720
2021-06-12 15:00:00,Hispanic or Latino,1303,279132,3062.0,220884,116.0,19836
2021-04-13 15:00:00,Not Hispanic or Latino,35695,1987381,31755.0,1257007,277.0,159945
2021-04-14 15:00:00,Not Hispanic or Latino,32602,2019983,32761.0,1289768,159.0,160104
2021-04-15 15:00:00,Not Hispanic or Latino,33611,2053594,33410.0,1323178,112.0,160216
2021-04-16 15:00:00,Not Hispanic or Latino,29338,2082932,32255.0,1355433,10.0,160226
2021-04-17 15:00:00,Not Hispanic or Latino,24413,2107345,17107.0,1372540,4.0,160230
2021-04-18 15:00:00,Not Hispanic or Latino,14691,2122036,13227.0,1385767,3.0,160233
2021-04-19 15:00:00,Not Hispanic or Latino,22406,2144442,29991.0,1415758,44.0,160277
2021-04-20 15:00:00,Not Hispanic or Latino,23928,2168370,37003.0,1452761,35.0,160312
2021-04-21 15:00:00,Not Hispanic or Latino,30490,2198860,38651.0,1491412,15.0,160327
2021-04-22 15:00:00,Not Hispanic or Latino,28601,2227461,35969.0,1527381,16.0,160343
2021-04-23 15:00:00,Not Hispanic or Latino,24962,2252423,33678.0,1561059,9.0,160352
2021-04-24 15:00:00,Not Hispanic or Latino,18925,2271348,24017.0,1585076,66.0,160418
2021-04-25 15:00:00,Not Hispanic or Latino,13940,2285288,6702.0,1591778,22.0,160440
2021-04-26 15:00:00,Not Hispanic or Latino,20485,2305773,26817.0,1618595,173.0,160613
2021-04-27 15:00:00,Not Hispanic or Latino,20858,2326631,28654.0,1647249,904.0,161517
2021-04-28 15:00:00,Not Hispanic or Latino,23183,2349814,32878.0,1680127,1120.0,162637
2021-04-29 15:00:00,Not Hispanic or Latino,21655,2371469,32250.0,1712377,1217.0,163854
2021-04-30 15:00:00,Not Hispanic or Latino,21852,2393321,26190.0,1738567,1337.0,165191
2021-05-01 15:00:00,Not Hispanic or Latino,13406,2406727,18849.0,1757416,785.0,165976
2021-05-02 15:00:00,Not Hispanic or Latino,6345,2413072,11201.0,1768617,645.0,166621
2021-05-03 15:00:00,Not Hispanic or Latino,9858,2422930,22231.0,1790848,1580.0,168201
2021-05-04 15:00:00,Not Hispanic or Latino,11458,2434388,32971.0,1823819,1448.0,169649
2021-05-05 15:00:00,Not Hispanic or Latino,14557,2448945,29832.0,1853651,1570.0,171219
2021-05-06 15:00:00,Not Hispanic or Latino,13243,2462188,31917.0,1885568,1443.0,172662
2021-05-07 15:00:00,Not Hispanic or Latino,12847,2475035,28175.0,1913743,1624.0,174286
2021-05-08 15:00:00,Not Hispanic or Latino,7439,2482474,23303.0,1937046,1003.0,175289
2021-05-09 15:00:00,Not Hispanic or Latino,3417,2485891,8806.0,1945852,554.0,175843
2021-05-10 15:00:00,Not Hispanic or Latino,6655,2492546,23282.0,1969134,1130.0,176973
2021-05-11 15:00:00,Not Hispanic or Latino,9589,2502135,24632.0,1993766,1201.0,178174
2021-05-12 15:00:00,Not Hispanic or Latino,10581,2512716,30138.0,2023904,1396.0,179570
2021-05-13 15:00:00,Not Hispanic or Latino,18165,2530881,27402.0,2051306,1091.0,180661
2021-05-14 15:00:00,Not Hispanic or Latino,19502,2550383,23177.0,2074483,1392.0,182053
2021-05-15 15:00:00,Not Hispanic or Latino,16407,2566790,17270.0,2091753,1041.0,183094
2021-05-16 15:00:00,Not Hispanic or Latino,7075,2573865,12994.0,2104747,705.0,183799
2021-05-17 15:00:00,Not Hispanic or Latino,13718,2587583,20819.0,2125566,1508.0,185307
2021-05-18 15:00:00,Not Hispanic or Latino,17142,2604725,24124.0,2149690,1511.0,186818
2021-05-19 15:00:00,Not Hispanic or Latino,22191,2626916,25609.0,2175299,1219.0,188037
2021-05-20 15:00:00,Not Hispanic or Latino,15730,2642646,25976.0,2201275,1555.0,189592
2021-05-21 15:00:00,Not Hispanic or Latino,15259,2657905,23499.0,2224774,1190.0,190782
2021-05-22 15:00:00,Not Hispanic or Latino,11515,2669420,14472.0,2239246,782.0,191564
2021-05-23 15:00:00,Not Hispanic or Latino,6291,2675711,8036.0,2247282,596.0,192160
2021-05-24 15:00:00,Not Hispanic or Latino,10300,2686011,13436.0,2260718,1066.0,193226
2021-05-25 15:00:00,Not Hispanic or Latino,9922,2695933,15331.0,2276049,1025.0,194251
2021-05-26 15:00:00,Not Hispanic or Latino,14478,2710411,15317.0,2291366,1162.0,195413
2021-05-27 15:00:00,Not Hispanic or Latino,8935,2719346,14407.0,2305773,868.0,196281
2021-05-28 15:00:00,Not Hispanic or Latino,9269,2728615,14803.0,2320576,1022.0,197303
2021-05-29 15:00:00,Not Hispanic or Latino,6140,2734755,7701.0,2328277,551.0,197854
2021-05-30 15:00:00,Not Hispanic or Latino,3363,2738118,4512.0,2332789,351.0,198205
2021-05-31 15:00:00,Not Hispanic or Latino,1186,2739304,2645.0,2335434,185.0,198390
2021-06-01 15:00:00,Not Hispanic or Latino,6975,2746279,13165.0,2348599,838.0,199228
2021-06-02 15:00:00,Not Hispanic or Latino,7518,2753797,13485.0,2362084,744.0,199972
2021-06-03 15:00:00,Not Hispanic or Latino,6000,2759797,17787.0,2379871,853.0,200825
2021-06-04 15:00:00,Not Hispanic or Latino,6291,2766088,17587.0,2397458,850.0,201675
2021-06-05 15:00:00,Not Hispanic or Latino,4911,2770999,15394.0,2412852,547.0,202222
2021-06-06 15:00:00,Not Hispanic or Latino,2239,2773238,5790.0,2418642,253.0,202475
2021-06-07 15:00:00,Not Hispanic or Latino,5037,2778275,13418.0,2432060,568.0,203043
2021-06-08 15:00:00,Not Hispanic or Latino,5030,2783305,16222.0,2448282,611.0,203654
2021-06-13 15:00:00,Hispanic or Latino,549,279681,1477.0,222361,108.0,19944
2021-06-14 15:00:00,Hispanic or Latino,1248,280929,1799.0,224160,125.0,20069
2021-06-15 15:00:00,Hispanic or Latino,1025,281954,2249.0,226409,126.0,20195
2021-06-16 15:00:00,Hispanic or Latino,1402,283356,2639.0,229048,102.0,20297
2021-06-17 15:00:00,Hispanic or Latino,1364,284720,1816.0,230864,105.0,20402
2021-06-18 15:00:00,Hispanic or Latino,1371,286091,2071.0,232935,112.0,20514
2021-06-19 15:00:00,Hispanic or Latino,1058,287149,2050.0,234985,155.0,20669
2021-06-20 15:00:00,Hispanic or Latino,644,287793,1197.0,236182,131.0,20800
2021-06-21 15:00:00,Hispanic or Latino,1240,289033,809.0,236991,107.0,20907
2021-06-22 15:00:00,Hispanic or Latino,1098,290131,1654.0,238645,145.0,21052
2021-06-23 15:00:00,Hispanic or Latino,1254,291385,1892.0,240537,84.0,21136
2021-06-24 15:00:00,Hispanic or Latino,1093,292478,1266.0,241803,105.0,21241
2021-06-25 15:00:00,Hispanic or Latino,1023,293501,1428.0,243231,76.0,21317
2021-06-26 15:00:00,Hispanic or Latino,900,294401,1442.0,244673,115.0,21432
2021-06-27 15:00:00,Hispanic or Latino,647,295048,822.0,245495,64.0,21496
2021-06-28 15:00:00,Hispanic or Latino,891,295939,1213.0,246708,66.0,21562
2021-06-29 15:00:00,Hispanic or Latino,980,296919,1191.0,247899,111.0,21673
2021-06-30 15:00:00,Hispanic or Latino,1094,298013,1472.0,249371,93.0,21766
2021-07-01 15:00:00,Hispanic or Latino,892,298905,1148.0,250519,66.0,21832
2021-07-02 15:00:00,Hispanic or Latino,1115,300020,1367.0,251886,92.0,21924
2021-07-03 15:00:00,Hispanic or Latino,769,300789,880.0,252766,83.0,22007
2021-07-04 15:00:00,Hispanic or Latino,108,300897,96.0,252862,8.0,22015
2021-07-05 15:00:00,Hispanic or Latino,737,301634,797.0,253659,43.0,22058
2021-07-06 15:00:00,Hispanic or Latino,817,302451,1095.0,254754,51.0,22109
2021-07-07 15:00:00,Hispanic or Latino,834,303285,1239.0,255993,50.0,22159
2021-07-08 15:00:00,Hispanic or Latino,867,304152,1197.0,257190,69.0,22228
2021-07-09 15:00:00,Hispanic or Latino,1000,305152,1223.0,258413,77.0,22305
2021-07-10 15:00:00,Hispanic or Latino,807,305959,934.0,259347,44.0,22349
2021-07-11 15:00:00,Hispanic or Latino,820,306779,610.0,259957,72.0,22421
2021-07-12 15:00:00,Hispanic or Latino,720,307499,977.0,260934,31.0,22452
2021-07-13 15:00:00,Hispanic or Latino,453,307952,445.0,261379,23.0,22475
2021-06-09 15:00:00,Not Hispanic or Latino,5710,2789015,19192.0,2467474,743.0,204397
2021-06-10 15:00:00,Not Hispanic or Latino,5342,2794357,15038.0,2482512,705.0,205102
2021-06-11 15:00:00,Not Hispanic or Latino,5215,2799572,13856.0,2496368,818.0,205920
2021-06-12 15:00:00,Not Hispanic or Latino,3406,2802978,10438.0,2506806,402.0,206322
2021-06-13 15:00:00,Not Hispanic or Latino,1153,2804131,5538.0,2512344,261.0,206583
2021-06-14 15:00:00,Not Hispanic or Latino,4071,2808202,9488.0,2521832,528.0,207111
2021-06-15 15:00:00,Not Hispanic or Latino,4137,2812339,11120.0,2532952,599.0,207710
2021-06-16 15:00:00,Not Hispanic or Latino,4850,2817189,14398.0,2547350,523.0,208233
2021-06-17 15:00:00,Not Hispanic or Latino,4782,2821971,9569.0,2556919,504.0,208737
2021-06-18 15:00:00,Not Hispanic or Latino,4635,2826606,9223.0,2566142,501.0,209238
2021-06-19 15:00:00,Not Hispanic or Latino,2844,2829450,5875.0,2572017,399.0,209637
2021-06-20 15:00:00,Not Hispanic or Latino,1320,2830770,3036.0,2575053,207.0,209844
2021-06-21 15:00:00,Not Hispanic or Latino,3853,2834623,4111.0,2579164,488.0,210332
2021-06-22 15:00:00,Not Hispanic or Latino,3591,2838214,6568.0,2585732,435.0,210767
2021-06-23 15:00:00,Not Hispanic or Latino,4267,2842481,7764.0,2593496,488.0,211255
2021-06-24 15:00:00,Not Hispanic or Latino,4011,2846492,6096.0,2599592,426.0,211681
2021-06-25 15:00:00,Not Hispanic or Latino,3787,2850279,5949.0,2605541,469.0,212150
2021-06-26 15:00:00,Not Hispanic or Latino,2443,2852722,4362.0,2609903,203.0,212353
2021-06-27 15:00:00,Not Hispanic or Latino,1606,2854328,2301.0,2612204,100.0,212453
2021-06-28 15:00:00,Not Hispanic or Latino,3184,2857512,4322.0,2616526,408.0,212861
2021-06-29 15:00:00,Not Hispanic or Latino,3557,2861069,4869.0,2621395,334.0,213195
2021-06-30 15:00:00,Not Hispanic or Latino,3966,2865035,5449.0,2626844,455.0,213650
2021-07-01 15:00:00,Not Hispanic or Latino,3534,2868569,4923.0,2631767,332.0,213982
2021-07-02 15:00:00,Not Hispanic or Latino,3494,2872063,4719.0,2636486,367.0,214349
2021-07-03 15:00:00,Not Hispanic or Latino,2052,2874115,2741.0,2639227,150.0,214499
2021-07-04 15:00:00,Not Hispanic or Latino,265,2874380,325.0,2639552,45.0,214544
2021-07-05 15:00:00,Not Hispanic or Latino,2589,2876969,2865.0,2642417,213.0,214757
2021-07-06 15:00:00,Not Hispanic or Latino,3241,2880210,4703.0,2647120,319.0,215076
2021-07-07 15:00:00,Not Hispanic or Latino,3185,2883395,4697.0,2651817,340.0,215416
2021-07-08 15:00:00,Not Hispanic or Latino,3272,2886667,4250.0,2656067,351.0,215767
2021-07-09 15:00:00,Not Hispanic or Latino,3684,2890351,4553.0,2660620,366.0,216133
2021-07-10 15:00:00,Not Hispanic or Latino,2297,2892648,2815.0,2663435,196.0,216329
2021-07-11 15:00:00,Not Hispanic or Latino,1405,2894053,1446.0,2664881,115.0,216444
2021-07-12 15:00:00,Not Hispanic or Latino,2881,2896934,3446.0,2668327,227.0,216671
2021-07-13 15:00:00,Not Hispanic or Latino,1379,2898313,1479.0,2669806,140.0,216811
