VACCINATION_DATE,Ethnicity,FirstDoseDaily,FirstDoseCumulative,SecondDoseDaily,SecondDoseCumulative,SingleDoseDaily,SingleDoseCumulative
2020-12-14 15:00:00,Unknown,1,1,,0,,0
2020-12-16 15:00:00,Unknown,10,11,,0,,0
2020-12-17 15:00:00,Unknown,20,31,,0,,0
2020-12-18 15:00:00,Unknown,93,124,,0,,0
2020-12-19 15:00:00,Unknown,37,161,,0,,0
2020-12-20 15:00:00,Unknown,29,190,,0,,0
2020-12-21 15:00:00,Unknown,72,262,1.0,1,,0
2020-12-22 15:00:00,Unknown,408,670,,1,,0
2020-12-23 15:00:00,Unknown,200,870,,1,,0
2020-12-24 15:00:00,Unknown,68,938,,1,,0
2020-12-25 15:00:00,Unknown,176,1114,,1,,0
2020-12-26 15:00:00,Unknown,195,1309,,1,,0
2020-12-27 15:00:00,Unknown,141,1450,,1,,0
2020-12-28 15:00:00,Unknown,292,1742,,1,,0
2020-12-29 15:00:00,Unknown,488,2230,,1,,0
2020-12-30 15:00:00,Unknown,379,2609,,1,,0
2020-12-31 15:00:00,Unknown,217,2826,,1,,0
2021-01-01 15:00:00,Unknown,149,2975,2.0,3,,0
2021-01-02 15:00:00,Unknown,174,3149,2.0,5,,0
2021-01-03 15:00:00,Unknown,224,3373,4.0,9,,0
2021-01-04 15:00:00,Unknown,589,3962,6.0,15,,0
2021-01-05 15:00:00,Unknown,515,4477,18.0,33,,0
2021-01-06 15:00:00,Unknown,653,5130,23.0,56,,0
2021-01-07 15:00:00,Unknown,411,5541,57.0,113,,0
2021-01-08 15:00:00,Unknown,8307,13848,76.0,189,,0
2021-01-09 15:00:00,Unknown,226,14074,46.0,235,,0
2021-01-10 15:00:00,Unknown,178,14252,9.0,244,,0
2021-01-11 15:00:00,Unknown,331,14583,85.0,329,,0
2021-01-12 15:00:00,Unknown,699,15282,345.0,674,,0
2021-01-13 15:00:00,Unknown,417,15699,134.0,808,,0
2021-01-14 15:00:00,Unknown,400,16099,63.0,871,,0
2021-01-15 15:00:00,Unknown,555,16654,179.0,1050,,0
2021-01-16 15:00:00,Unknown,290,16944,153.0,1203,,0
2021-01-17 15:00:00,Unknown,111,17055,94.0,1297,,0
2021-01-18 15:00:00,Unknown,164,17219,200.0,1497,,0
2021-01-19 15:00:00,Unknown,335,17554,287.0,1784,,0
2021-01-20 15:00:00,Unknown,420,17974,182.0,1966,,0
2021-01-21 15:00:00,Unknown,510,18484,108.0,2074,,0
2021-01-22 15:00:00,Unknown,729,19213,169.0,2243,,0
2021-01-23 15:00:00,Unknown,459,19672,162.0,2405,,0
2021-01-24 15:00:00,Unknown,201,19873,145.0,2550,,0
2021-01-25 15:00:00,Unknown,599,20472,466.0,3016,,0
2021-01-26 15:00:00,Unknown,679,21151,373.0,3389,,0
2021-01-27 15:00:00,Unknown,615,21766,538.0,3927,,0
2021-01-28 15:00:00,Unknown,590,22356,273.0,4200,,0
2021-01-29 15:00:00,Unknown,659,23015,210.0,4410,,0
2021-01-30 15:00:00,Unknown,478,23493,62.0,4472,,0
2021-01-31 15:00:00,Unknown,439,23932,83.0,4555,,0
2021-02-01 15:00:00,Unknown,478,24410,214.0,4769,,0
2021-02-02 15:00:00,Unknown,665,25075,643.0,5412,,0
2021-02-03 15:00:00,Unknown,803,25878,478.0,5890,,0
2021-02-04 15:00:00,Unknown,894,26772,442.0,6332,,0
2021-02-05 15:00:00,Unknown,724,27496,438.0,6770,,0
2021-02-06 15:00:00,Unknown,587,28083,8208.0,14978,,0
2021-02-07 15:00:00,Unknown,384,28467,88.0,15066,,0
2021-04-13 15:00:00,Federal Entities,84295,84295,54201.0,54201,2952.0,2952
2021-04-14 15:00:00,Federal Entities,557,84852,11.0,54212,1.0,2953
2021-04-15 15:00:00,Federal Entities,623,85475,823.0,55035,19.0,2972
2021-04-16 15:00:00,Federal Entities,782,86257,1016.0,56051,8.0,2980
2021-04-17 15:00:00,Federal Entities,1136,87393,1177.0,57228,6.0,2986
2021-04-19 15:00:00,Federal Entities,1369,88762,2003.0,59231,9.0,2995
2021-04-20 15:00:00,Federal Entities,3243,92005,2158.0,61389,19.0,3014
2021-04-21 15:00:00,Federal Entities,906,92911,1206.0,62595,4.0,3018
2021-04-22 15:00:00,Federal Entities,1018,93929,458.0,63053,,3018
2021-04-23 15:00:00,Federal Entities,759,94688,632.0,63685,1.0,3019
2021-04-25 15:00:00,Federal Entities,992,95680,2492.0,66177,5.0,3024
2021-04-26 15:00:00,Federal Entities,1483,97163,1672.0,67849,1.0,3025
2021-04-29 15:00:00,Federal Entities,223,97386,865.0,68714,2.0,3027
2021-05-01 15:00:00,Federal Entities,1556,98942,1974.0,70688,14.0,3041
2021-05-02 15:00:00,Federal Entities,1071,100013,1875.0,72563,4.0,3045
2021-05-03 15:00:00,Federal Entities,403,100416,2165.0,74728,4.0,3049
2021-05-04 15:00:00,Federal Entities,28,100444,25.0,74753,,3049
2021-05-05 15:00:00,Federal Entities,365,100809,814.0,75567,,3049
2021-05-06 15:00:00,Federal Entities,275,101084,880.0,76447,3.0,3052
2021-05-07 15:00:00,Federal Entities,274,101358,966.0,77413,8.0,3060
2021-05-08 15:00:00,Federal Entities,297,101655,1312.0,78725,6.0,3066
2021-05-10 15:00:00,Federal Entities,338,101993,1712.0,80437,1.0,3067
2021-05-11 15:00:00,Federal Entities,18,102011,13.0,80450,,3067
2021-05-12 15:00:00,Federal Entities,243,102254,1124.0,81574,,3067
2021-05-14 15:00:00,Federal Entities,290,102544,1022.0,82596,2.0,3069
2021-05-15 15:00:00,Federal Entities,611,103155,1701.0,84297,4.0,3073
2021-05-17 15:00:00,Federal Entities,565,103720,2505.0,86802,11.0,3084
2021-05-18 15:00:00,Federal Entities,164,103884,61.0,86863,2.0,3086
2021-05-20 15:00:00,Federal Entities,885,104769,1024.0,87887,,3086
2021-05-22 15:00:00,Federal Entities,911,105680,1359.0,89246,9.0,3095
2021-05-24 15:00:00,Federal Entities,514,106194,1032.0,90278,8.0,3103
2021-05-25 15:00:00,Federal Entities,5,106199,1.0,90279,2.0,3105
2021-05-27 15:00:00,Federal Entities,425,106624,674.0,90953,1.0,3106
2021-05-28 15:00:00,Federal Entities,418,107042,342.0,91295,,3106
2021-05-29 15:00:00,Federal Entities,267,107309,344.0,91639,10.0,3116
2021-05-31 15:00:00,Federal Entities,214,107523,243.0,91882,3.0,3119
2021-06-01 15:00:00,Federal Entities,30,107553,48.0,91930,,3119
2021-06-16 15:00:00,Federal Entities,2042,109595,3555.0,95485,37.0,3156
2021-06-17 15:00:00,Federal Entities,22,109617,95.0,95580,,3156
2021-06-18 15:00:00,Federal Entities,269,109886,456.0,96036,4.0,3160
2021-06-19 15:00:00,Federal Entities,166,110052,338.0,96374,1.0,3161
2021-06-20 15:00:00,Federal Entities,161,110213,284.0,96658,1.0,3162
2021-06-21 15:00:00,Federal Entities,56,110269,120.0,96778,1.0,3163
2021-06-22 15:00:00,Federal Entities,13,110282,8.0,96786,1.0,3164
2021-06-23 15:00:00,Federal Entities,2,110284,2.0,96788,,3164
2021-06-24 15:00:00,Federal Entities,304,110588,355.0,97143,5.0,3169
2021-06-25 15:00:00,Federal Entities,124,110712,209.0,97352,1.0,3170
2021-06-27 15:00:00,Federal Entities,124,110836,173.0,97525,2.0,3172
2021-06-28 15:00:00,Federal Entities,146,110982,186.0,97711,4.0,3176
2021-06-29 15:00:00,Federal Entities,2,110984,2.0,97713,1.0,3177
2021-07-01 15:00:00,Federal Entities,313,111297,340.0,98053,8.0,3185
2021-07-02 15:00:00,Federal Entities,209,111506,249.0,98302,6.0,3191
2021-07-03 15:00:00,Federal Entities,97,111603,123.0,98425,4.0,3195
2021-07-04 15:00:00,Federal Entities,75,111678,98.0,98523,6.0,3201
2021-07-05 15:00:00,Federal Entities,7,111685,8.0,98531,,3201
2021-02-08 15:00:00,Unknown,771,29238,317.0,15383,,0
2021-02-09 15:00:00,Unknown,767,30005,350.0,15733,,0
2021-02-10 15:00:00,Unknown,790,30795,459.0,16192,,0
2021-02-11 15:00:00,Unknown,848,31643,451.0,16643,,0
2021-02-12 15:00:00,Unknown,731,32374,592.0,17235,,0
2021-02-13 15:00:00,Unknown,399,32773,179.0,17414,,0
2021-02-14 15:00:00,Unknown,427,33200,121.0,17535,,0
2021-02-15 15:00:00,Unknown,440,33640,533.0,18068,,0
2021-02-16 15:00:00,Unknown,701,34341,807.0,18875,,0
2021-02-17 15:00:00,Unknown,784,35125,612.0,19487,,0
2021-02-18 15:00:00,Unknown,254,35379,269.0,19756,,0
2021-02-19 15:00:00,Unknown,503,35882,544.0,20300,,0
2021-02-20 15:00:00,Unknown,569,36451,582.0,20882,,0
2021-02-21 15:00:00,Unknown,336,36787,398.0,21280,,0
2021-02-22 15:00:00,Unknown,436,37223,519.0,21799,,0
2021-02-23 15:00:00,Unknown,661,37884,515.0,22314,,0
2021-02-24 15:00:00,Unknown,614,38498,600.0,22914,,0
2021-02-25 15:00:00,Unknown,610,39108,837.0,23751,,0
2021-02-26 15:00:00,Unknown,757,39865,850.0,24601,,0
2021-02-27 15:00:00,Unknown,562,40427,443.0,25044,,0
2021-02-28 15:00:00,Unknown,607,41034,220.0,25264,,0
2021-03-01 15:00:00,Unknown,864,41898,555.0,25819,,0
2021-03-02 15:00:00,Unknown,784,42682,560.0,26379,1.0,1
2021-03-03 15:00:00,Unknown,988,43670,599.0,26978,3.0,4
2021-03-04 15:00:00,Unknown,956,44626,671.0,27649,100.0,104
2021-03-05 15:00:00,Unknown,1009,45635,569.0,28218,87.0,191
2021-03-06 15:00:00,Unknown,635,46270,301.0,28519,188.0,379
2021-03-07 15:00:00,Unknown,514,46784,326.0,28845,283.0,662
2021-03-08 15:00:00,Unknown,966,47750,343.0,29188,351.0,1013
2021-03-09 15:00:00,Unknown,930,48680,450.0,29638,360.0,1373
2021-03-10 15:00:00,Unknown,878,49558,480.0,30118,482.0,1855
2021-03-11 15:00:00,Unknown,1299,50857,503.0,30621,203.0,2058
2021-03-12 15:00:00,Unknown,1244,52101,594.0,31215,162.0,2220
2021-03-13 15:00:00,Unknown,829,52930,356.0,31571,73.0,2293
2021-03-14 15:00:00,Unknown,1000,53930,339.0,31910,66.0,2359
2021-03-15 15:00:00,Unknown,1660,55590,423.0,32333,37.0,2396
2021-03-16 15:00:00,Unknown,1620,57210,602.0,32935,41.0,2437
2021-03-17 15:00:00,Unknown,1639,58849,682.0,33617,67.0,2504
2021-03-18 15:00:00,Unknown,1770,60619,482.0,34099,60.0,2564
2021-03-19 15:00:00,Unknown,1461,62080,483.0,34582,59.0,2623
2021-03-20 15:00:00,Unknown,1246,63326,431.0,35013,155.0,2778
2021-03-21 15:00:00,Unknown,1054,64380,474.0,35487,25.0,2803
2021-03-22 15:00:00,Unknown,1547,65927,532.0,36019,33.0,2836
2021-03-23 15:00:00,Unknown,1926,67853,641.0,36660,70.0,2906
2021-03-24 15:00:00,Unknown,2570,70423,545.0,37205,72.0,2978
2021-03-25 15:00:00,Unknown,2594,73017,616.0,37821,322.0,3300
2021-03-26 15:00:00,Unknown,2554,75571,720.0,38541,346.0,3646
2021-03-27 15:00:00,Unknown,2078,77649,518.0,39059,492.0,4138
2021-03-28 15:00:00,Unknown,1842,79491,492.0,39551,407.0,4545
2021-03-29 15:00:00,Unknown,2586,82077,994.0,40545,76.0,4621
2021-03-30 15:00:00,Unknown,2447,84524,1025.0,41570,125.0,4746
2021-03-31 15:00:00,Unknown,2456,86980,930.0,42500,776.0,5522
2021-04-01 15:00:00,Unknown,1581,88561,1297.0,43797,617.0,6139
2021-04-02 15:00:00,Unknown,1834,90395,1350.0,45147,736.0,6875
2021-04-03 15:00:00,Unknown,1623,92018,826.0,45973,648.0,7523
2021-04-04 15:00:00,Unknown,587,92605,643.0,46616,46.0,7569
2021-04-05 15:00:00,Unknown,1857,94462,1162.0,47778,654.0,8223
2021-04-06 15:00:00,Unknown,2194,96656,1269.0,49047,851.0,9074
2021-04-07 15:00:00,Unknown,2442,99098,1362.0,50409,1301.0,10375
2021-04-08 15:00:00,Unknown,3051,102149,1499.0,51908,1472.0,11847
2021-04-09 15:00:00,Unknown,3319,105468,1082.0,52990,1247.0,13094
2021-04-10 15:00:00,Unknown,2926,108394,1025.0,54015,956.0,14050
2021-04-11 15:00:00,Unknown,2446,110840,1042.0,55057,1024.0,15074
2021-04-12 15:00:00,Unknown,2752,113592,1832.0,56889,1060.0,16134
2021-04-13 15:00:00,Unknown,3269,116861,1905.0,58794,34.0,16168
2021-04-14 15:00:00,Unknown,3129,119990,2156.0,60950,10.0,16178
2021-04-15 15:00:00,Unknown,3779,123769,2328.0,63278,14.0,16192
2021-04-16 15:00:00,Unknown,3388,127157,2362.0,65640,2.0,16194
2021-04-17 15:00:00,Unknown,3670,130827,1594.0,67234,1.0,16195
2021-04-18 15:00:00,Unknown,2874,133701,1633.0,68867,,16195
2021-04-19 15:00:00,Unknown,2747,136448,2399.0,71266,2.0,16197
2021-04-20 15:00:00,Unknown,2234,138682,2132.0,73398,,16197
2021-04-21 15:00:00,Unknown,3040,141722,2520.0,75918,1.0,16198
2021-04-22 15:00:00,Unknown,2696,144418,1308.0,77226,,16198
2021-04-23 15:00:00,Unknown,3156,147574,1972.0,79198,2.0,16200
2021-04-24 15:00:00,Unknown,3052,150626,1777.0,80975,3.0,16203
2021-04-25 15:00:00,Unknown,2340,152966,753.0,81728,,16203
2021-04-26 15:00:00,Unknown,1769,154735,1582.0,83310,11.0,16214
2021-04-27 15:00:00,Unknown,2295,157030,1492.0,84802,80.0,16294
2021-04-28 15:00:00,Unknown,2078,159108,2558.0,87360,93.0,16387
2021-04-29 15:00:00,Unknown,1828,160936,2725.0,90085,83.0,16470
2021-04-30 15:00:00,Unknown,1960,162896,2784.0,92869,112.0,16582
2021-05-01 15:00:00,Unknown,1564,164460,2747.0,95616,57.0,16639
2021-05-02 15:00:00,Unknown,1179,165639,2210.0,97826,33.0,16672
2021-05-03 15:00:00,Unknown,779,166418,2768.0,100594,87.0,16759
2021-05-04 15:00:00,Unknown,762,167180,3039.0,103633,101.0,16860
2021-05-05 15:00:00,Unknown,1391,168571,2968.0,106601,114.0,16974
2021-05-06 15:00:00,Unknown,1182,169753,3306.0,109907,96.0,17070
2021-05-07 15:00:00,Unknown,1257,171010,2923.0,112830,113.0,17183
2021-05-08 15:00:00,Unknown,1011,172021,3142.0,115972,107.0,17290
2021-05-09 15:00:00,Unknown,682,172703,1519.0,117491,36.0,17326
2021-05-10 15:00:00,Unknown,626,173329,2880.0,120371,80.0,17406
2021-05-11 15:00:00,Unknown,744,174073,2343.0,122714,85.0,17491
2021-05-12 15:00:00,Unknown,878,174951,2744.0,125458,163.0,17654
2021-05-13 15:00:00,Unknown,1044,175995,2318.0,127776,142.0,17796
2021-05-14 15:00:00,Unknown,1194,177189,2400.0,130176,187.0,17983
2021-05-15 15:00:00,Unknown,1413,178602,2450.0,132626,249.0,18232
2021-05-16 15:00:00,Unknown,565,179167,2103.0,134729,198.0,18430
2021-05-17 15:00:00,Unknown,603,179770,1756.0,136485,225.0,18655
2021-05-18 15:00:00,Unknown,1058,180828,2567.0,139052,190.0,18845
2021-05-19 15:00:00,Unknown,1237,182065,2509.0,141561,165.0,19010
2021-05-20 15:00:00,Unknown,1014,183079,2141.0,143702,175.0,19185
2021-05-21 15:00:00,Unknown,1099,184178,2067.0,145769,197.0,19382
2021-05-22 15:00:00,Unknown,1157,185335,1213.0,146982,232.0,19614
2021-05-23 15:00:00,Unknown,651,185986,1276.0,148258,192.0,19806
2021-05-24 15:00:00,Unknown,606,186592,845.0,149103,225.0,20031
2021-07-06 15:00:00,Federal Entities,18,111703,22.0,98553,4.0,3205
2021-07-08 15:00:00,Federal Entities,105,111808,155.0,98708,5.0,3210
2021-07-09 15:00:00,Federal Entities,136,111944,203.0,98911,9.0,3219
2021-07-10 15:00:00,Federal Entities,130,112074,140.0,99051,4.0,3223
2021-07-11 15:00:00,Federal Entities,145,112219,137.0,99188,4.0,3227
2021-07-13 15:00:00,Federal Entities,3,112222,1.0,99189,,3227
2021-07-14 15:00:00,Federal Entities,57,112279,57.0,99246,3.0,3230
2021-07-15 15:00:00,Federal Entities,56,112335,90.0,99336,4.0,3234
2021-07-16 15:00:00,Federal Entities,1012,113347,526.0,99862,24.0,3258
2021-07-17 15:00:00,Federal Entities,86,113433,116.0,99978,4.0,3262
2021-07-18 15:00:00,Federal Entities,152,113585,219.0,100197,10.0,3272
2021-07-19 15:00:00,Federal Entities,11,113596,10.0,100207,5.0,3277
2021-07-21 15:00:00,Federal Entities,4,113600,3.0,100210,,3277
2021-07-22 15:00:00,Federal Entities,27,113627,35.0,100245,,3277
2021-07-23 15:00:00,Federal Entities,12,113639,13.0,100258,,3277
2021-07-25 15:00:00,Federal Entities,19,113658,7.0,100265,,3277
2020-12-14 15:00:00,Hispanic or Latino,1,1,,0,,0
2020-12-15 15:00:00,Hispanic or Latino,4,5,,0,,0
2020-12-16 15:00:00,Hispanic or Latino,19,24,,0,,0
2020-12-17 15:00:00,Hispanic or Latino,38,62,,0,,0
2020-12-18 15:00:00,Hispanic or Latino,86,148,,0,,0
2020-12-19 15:00:00,Hispanic or Latino,37,185,,0,,0
2020-12-20 15:00:00,Hispanic or Latino,10,195,,0,,0
2020-12-21 15:00:00,Hispanic or Latino,147,342,1.0,1,,0
2020-12-22 15:00:00,Hispanic or Latino,257,599,,1,,0
2020-12-23 15:00:00,Hispanic or Latino,190,789,1.0,2,,0
2020-12-24 15:00:00,Hispanic or Latino,92,881,,2,,0
2020-12-25 15:00:00,Hispanic or Latino,39,920,,2,,0
2020-12-26 15:00:00,Hispanic or Latino,47,967,,2,,0
2020-12-27 15:00:00,Hispanic or Latino,60,1027,,2,,0
2020-12-28 15:00:00,Hispanic or Latino,264,1291,1.0,3,,0
2020-12-29 15:00:00,Hispanic or Latino,368,1659,2.0,5,,0
2020-12-30 15:00:00,Hispanic or Latino,506,2165,2.0,7,,0
2020-12-31 15:00:00,Hispanic or Latino,328,2493,2.0,9,,0
2021-01-01 15:00:00,Hispanic or Latino,71,2564,6.0,15,,0
2021-01-02 15:00:00,Hispanic or Latino,92,2656,3.0,18,,0
2021-01-03 15:00:00,Hispanic or Latino,124,2780,4.0,22,,0
2021-01-04 15:00:00,Hispanic or Latino,623,3403,12.0,34,,0
2021-01-05 15:00:00,Hispanic or Latino,418,3821,19.0,53,,0
2021-01-06 15:00:00,Hispanic or Latino,604,4425,21.0,74,,0
2021-01-07 15:00:00,Hispanic or Latino,809,5234,62.0,136,,0
2021-01-08 15:00:00,Hispanic or Latino,873,6107,92.0,228,,0
2021-01-09 15:00:00,Hispanic or Latino,195,6302,34.0,262,,0
2021-01-10 15:00:00,Hispanic or Latino,138,6440,22.0,284,,0
2021-01-11 15:00:00,Hispanic or Latino,551,6991,130.0,414,,0
2021-01-12 15:00:00,Hispanic or Latino,740,7731,209.0,623,,0
2021-01-13 15:00:00,Hispanic or Latino,677,8408,134.0,757,,0
2021-01-14 15:00:00,Hispanic or Latino,748,9156,70.0,827,,0
2021-01-15 15:00:00,Hispanic or Latino,881,10037,69.0,896,,0
2021-01-16 15:00:00,Hispanic or Latino,186,10223,42.0,938,,0
2021-01-17 15:00:00,Hispanic or Latino,98,10321,46.0,984,,0
2021-01-18 15:00:00,Hispanic or Latino,165,10486,118.0,1102,,0
2021-01-19 15:00:00,Hispanic or Latino,482,10968,162.0,1264,,0
2021-01-20 15:00:00,Hispanic or Latino,626,11594,189.0,1453,,0
2021-01-21 15:00:00,Hispanic or Latino,760,12354,123.0,1576,,0
2021-01-22 15:00:00,Hispanic or Latino,972,13326,108.0,1684,,0
2021-01-23 15:00:00,Hispanic or Latino,322,13648,69.0,1753,,0
2021-01-24 15:00:00,Hispanic or Latino,90,13738,45.0,1798,,0
2021-01-25 15:00:00,Hispanic or Latino,371,14109,315.0,2113,,0
2021-01-26 15:00:00,Hispanic or Latino,481,14590,241.0,2354,,0
2021-01-27 15:00:00,Hispanic or Latino,752,15342,440.0,2794,,0
2021-05-25 15:00:00,Unknown,779,187371,869.0,149972,139.0,20170
2021-05-26 15:00:00,Unknown,901,188272,1121.0,151093,182.0,20352
2021-05-27 15:00:00,Unknown,632,188904,995.0,152088,138.0,20490
2021-05-28 15:00:00,Unknown,665,189569,1236.0,153324,184.0,20674
2021-05-29 15:00:00,Unknown,730,190299,1230.0,154554,229.0,20903
2021-05-30 15:00:00,Unknown,367,190666,861.0,155415,139.0,21042
2021-05-31 15:00:00,Unknown,65,190731,203.0,155618,73.0,21115
2021-06-01 15:00:00,Unknown,537,191268,928.0,156546,136.0,21251
2021-06-02 15:00:00,Unknown,529,191797,1008.0,157554,84.0,21335
2021-06-03 15:00:00,Unknown,415,192212,1008.0,158562,104.0,21439
2021-06-04 15:00:00,Unknown,440,192652,1124.0,159686,65.0,21504
2021-06-05 15:00:00,Unknown,488,193140,1171.0,160857,48.0,21552
2021-06-06 15:00:00,Unknown,207,193347,480.0,161337,70.0,21622
2021-06-07 15:00:00,Unknown,350,193697,431.0,161768,54.0,21676
2021-06-08 15:00:00,Unknown,367,194064,780.0,162548,82.0,21758
2021-06-09 15:00:00,Unknown,463,194527,940.0,163488,64.0,21822
2021-06-10 15:00:00,Unknown,430,194957,868.0,164356,71.0,21893
2021-06-11 15:00:00,Unknown,463,195420,897.0,165253,108.0,22001
2021-06-12 15:00:00,Unknown,448,195868,1055.0,166308,87.0,22088
2021-06-13 15:00:00,Unknown,221,196089,483.0,166791,55.0,22143
2021-06-14 15:00:00,Unknown,300,196389,396.0,167187,60.0,22203
2021-06-15 15:00:00,Unknown,373,196762,790.0,167977,107.0,22310
2021-06-16 15:00:00,Unknown,318,197080,711.0,168688,72.0,22382
2021-06-17 15:00:00,Unknown,338,197418,545.0,169233,89.0,22471
2021-06-18 15:00:00,Unknown,344,197762,589.0,169822,58.0,22529
2021-06-19 15:00:00,Unknown,265,198027,627.0,170449,50.0,22579
2021-06-20 15:00:00,Unknown,153,198180,250.0,170699,33.0,22612
2021-06-21 15:00:00,Unknown,285,198465,178.0,170877,31.0,22643
2021-06-22 15:00:00,Unknown,350,198815,498.0,171375,93.0,22736
2021-06-23 15:00:00,Unknown,332,199147,452.0,171827,45.0,22781
2021-06-24 15:00:00,Unknown,322,199469,322.0,172149,44.0,22825
2021-06-25 15:00:00,Unknown,312,199781,347.0,172496,52.0,22877
2021-06-26 15:00:00,Unknown,258,200039,381.0,172877,60.0,22937
2021-06-27 15:00:00,Unknown,210,200249,164.0,173041,15.0,22952
2021-06-28 15:00:00,Unknown,369,200618,218.0,173259,33.0,22985
2021-06-29 15:00:00,Unknown,395,201013,318.0,173577,54.0,23039
2021-06-30 15:00:00,Unknown,345,201358,294.0,173871,40.0,23079
2021-07-01 15:00:00,Unknown,335,201693,346.0,174217,52.0,23131
2021-07-02 15:00:00,Unknown,319,202012,344.0,174561,34.0,23165
2021-07-03 15:00:00,Unknown,277,202289,276.0,174837,23.0,23188
2021-07-04 15:00:00,Unknown,29,202318,14.0,174851,4.0,23192
2021-07-05 15:00:00,Unknown,352,202670,203.0,175054,15.0,23207
2021-07-06 15:00:00,Unknown,347,203017,293.0,175347,59.0,23266
2021-07-07 15:00:00,Unknown,347,203364,235.0,175582,28.0,23294
2021-07-08 15:00:00,Unknown,388,203752,214.0,175796,31.0,23325
2021-07-09 15:00:00,Unknown,337,204089,256.0,176052,63.0,23388
2021-07-10 15:00:00,Unknown,313,204402,217.0,176269,34.0,23422
2021-07-11 15:00:00,Unknown,211,204613,178.0,176447,16.0,23438
2021-07-12 15:00:00,Unknown,305,204918,204.0,176651,22.0,23460
2021-07-13 15:00:00,Unknown,365,205283,218.0,176869,18.0,23478
2021-07-14 15:00:00,Unknown,323,205606,205.0,177074,16.0,23494
2021-07-15 15:00:00,Unknown,326,205932,206.0,177280,11.0,23505
2021-07-16 15:00:00,Unknown,366,206298,207.0,177487,14.0,23519
2021-01-28 15:00:00,Hispanic or Latino,803,16145,398.0,3192,,0
2021-01-29 15:00:00,Hispanic or Latino,731,16876,304.0,3496,,0
2021-01-30 15:00:00,Hispanic or Latino,508,17384,93.0,3589,,0
2021-01-31 15:00:00,Hispanic or Latino,139,17523,30.0,3619,,0
2021-02-01 15:00:00,Hispanic or Latino,180,17703,164.0,3783,,0
2021-02-02 15:00:00,Hispanic or Latino,418,18121,602.0,4385,,0
2021-02-03 15:00:00,Hispanic or Latino,620,18741,667.0,5052,,0
2021-02-04 15:00:00,Hispanic or Latino,749,19490,721.0,5773,,0
2021-02-05 15:00:00,Hispanic or Latino,776,20266,870.0,6643,,0
2021-02-06 15:00:00,Hispanic or Latino,399,20665,207.0,6850,,0
2021-02-07 15:00:00,Hispanic or Latino,166,20831,66.0,6916,,0
2021-02-08 15:00:00,Hispanic or Latino,550,21381,618.0,7534,,0
2021-02-09 15:00:00,Hispanic or Latino,548,21929,530.0,8064,,0
2021-02-10 15:00:00,Hispanic or Latino,698,22627,694.0,8758,,0
2021-02-11 15:00:00,Hispanic or Latino,865,23492,733.0,9491,,0
2021-02-12 15:00:00,Hispanic or Latino,777,24269,859.0,10350,,0
2021-02-13 15:00:00,Hispanic or Latino,371,24640,224.0,10574,,0
2021-02-14 15:00:00,Hispanic or Latino,277,24917,66.0,10640,,0
2021-02-15 15:00:00,Hispanic or Latino,324,25241,361.0,11001,,0
2021-02-16 15:00:00,Hispanic or Latino,517,25758,538.0,11539,,0
2021-02-17 15:00:00,Hispanic or Latino,693,26451,753.0,12292,,0
2021-02-18 15:00:00,Hispanic or Latino,116,26567,133.0,12425,,0
2021-02-19 15:00:00,Hispanic or Latino,365,26932,773.0,13198,,0
2021-02-20 15:00:00,Hispanic or Latino,364,27296,638.0,13836,,0
2021-02-21 15:00:00,Hispanic or Latino,312,27608,251.0,14087,,0
2021-02-22 15:00:00,Hispanic or Latino,287,27895,421.0,14508,,0
2021-02-23 15:00:00,Hispanic or Latino,533,28428,494.0,15002,,0
2021-02-24 15:00:00,Hispanic or Latino,573,29001,827.0,15829,,0
2021-02-25 15:00:00,Hispanic or Latino,779,29780,830.0,16659,,0
2021-02-26 15:00:00,Hispanic or Latino,1135,30915,855.0,17514,,0
2021-02-27 15:00:00,Hispanic or Latino,671,31586,348.0,17862,,0
2021-02-28 15:00:00,Hispanic or Latino,739,32325,183.0,18045,,0
2021-03-01 15:00:00,Hispanic or Latino,1162,33487,431.0,18476,,0
2021-03-02 15:00:00,Hispanic or Latino,1054,34541,354.0,18830,1.0,1
2021-03-03 15:00:00,Hispanic or Latino,1182,35723,665.0,19495,13.0,14
2021-03-04 15:00:00,Hispanic or Latino,1352,37075,507.0,20002,148.0,162
2021-03-05 15:00:00,Hispanic or Latino,1680,38755,611.0,20613,202.0,364
2021-03-06 15:00:00,Hispanic or Latino,900,39655,274.0,20887,380.0,744
2021-03-07 15:00:00,Hispanic or Latino,580,40235,198.0,21085,288.0,1032
2021-03-08 15:00:00,Hispanic or Latino,1230,41465,312.0,21397,365.0,1397
2021-03-09 15:00:00,Hispanic or Latino,1240,42705,469.0,21866,442.0,1839
2021-03-10 15:00:00,Hispanic or Latino,1403,44108,615.0,22481,532.0,2371
2021-03-11 15:00:00,Hispanic or Latino,1685,45793,672.0,23153,255.0,2626
2021-03-12 15:00:00,Hispanic or Latino,2096,47889,672.0,23825,225.0,2851
2021-03-13 15:00:00,Hispanic or Latino,1214,49103,388.0,24213,212.0,3063
2021-03-14 15:00:00,Hispanic or Latino,1545,50648,218.0,24431,109.0,3172
2021-03-15 15:00:00,Hispanic or Latino,1793,52441,350.0,24781,45.0,3217
2021-03-16 15:00:00,Hispanic or Latino,2074,54515,436.0,25217,20.0,3237
2021-03-17 15:00:00,Hispanic or Latino,2497,57012,600.0,25817,59.0,3296
2021-03-18 15:00:00,Hispanic or Latino,2621,59633,406.0,26223,96.0,3392
2021-03-19 15:00:00,Hispanic or Latino,2634,62267,548.0,26771,82.0,3474
2021-03-20 15:00:00,Hispanic or Latino,2142,64409,428.0,27199,50.0,3524
2021-03-21 15:00:00,Hispanic or Latino,1626,66035,456.0,27655,15.0,3539
2021-03-22 15:00:00,Hispanic or Latino,2256,68291,449.0,28104,33.0,3572
2021-03-23 15:00:00,Hispanic or Latino,2663,70954,626.0,28730,131.0,3703
2021-03-24 15:00:00,Hispanic or Latino,3204,74158,837.0,29567,207.0,3910
2021-03-25 15:00:00,Hispanic or Latino,3354,77512,857.0,30424,115.0,4025
2021-03-26 15:00:00,Hispanic or Latino,2530,80042,1267.0,31691,198.0,4223
2021-03-27 15:00:00,Hispanic or Latino,2242,82284,814.0,32505,153.0,4376
2021-03-28 15:00:00,Hispanic or Latino,1121,83405,551.0,33056,73.0,4449
2021-03-29 15:00:00,Hispanic or Latino,2019,85424,1268.0,34324,60.0,4509
2021-03-30 15:00:00,Hispanic or Latino,2769,88193,1201.0,35525,109.0,4618
2021-07-17 15:00:00,Unknown,311,206609,156.0,177643,12.0,23531
2021-07-18 15:00:00,Unknown,274,206883,122.0,177765,4.0,23535
2021-07-19 15:00:00,Unknown,416,207299,227.0,177992,20.0,23555
2021-07-20 15:00:00,Unknown,446,207745,238.0,178230,26.0,23581
2021-07-21 15:00:00,Unknown,376,208121,195.0,178425,16.0,23597
2021-07-22 15:00:00,Unknown,459,208580,175.0,178600,14.0,23611
2021-07-23 15:00:00,Unknown,459,209039,191.0,178791,17.0,23628
2021-07-24 15:00:00,Unknown,517,209556,147.0,178938,7.0,23635
2021-07-25 15:00:00,Unknown,137,209693,23.0,178961,4.0,23639
2020-12-14 15:00:00,Not Hispanic or Latino,10,10,,0,,0
2020-12-15 15:00:00,Not Hispanic or Latino,27,37,2.0,2,,0
2020-12-16 15:00:00,Not Hispanic or Latino,534,571,1.0,3,,0
2020-12-17 15:00:00,Not Hispanic or Latino,1051,1622,1.0,4,,0
2020-12-18 15:00:00,Not Hispanic or Latino,2783,4405,6.0,10,,0
2020-12-19 15:00:00,Not Hispanic or Latino,833,5238,2.0,12,,0
2020-12-20 15:00:00,Not Hispanic or Latino,262,5500,3.0,15,,0
2020-12-21 15:00:00,Not Hispanic or Latino,3593,9093,8.0,23,,0
2020-12-22 15:00:00,Not Hispanic or Latino,5621,14714,7.0,30,,0
2020-12-23 15:00:00,Not Hispanic or Latino,5294,20008,14.0,44,,0
2020-12-24 15:00:00,Not Hispanic or Latino,2521,22529,6.0,50,,0
2020-12-25 15:00:00,Not Hispanic or Latino,816,23345,2.0,52,,0
2020-12-26 15:00:00,Not Hispanic or Latino,1602,24947,4.0,56,,0
2020-12-27 15:00:00,Not Hispanic or Latino,1577,26524,6.0,62,,0
2020-12-28 15:00:00,Not Hispanic or Latino,8318,34842,21.0,83,,0
2020-12-29 15:00:00,Not Hispanic or Latino,10011,44853,12.0,95,,0
2020-12-30 15:00:00,Not Hispanic or Latino,11506,56359,37.0,132,,0
2020-12-31 15:00:00,Not Hispanic or Latino,6924,63283,17.0,149,,0
2021-01-01 15:00:00,Not Hispanic or Latino,1770,65053,49.0,198,,0
2021-01-02 15:00:00,Not Hispanic or Latino,2637,67690,23.0,221,,0
2021-01-03 15:00:00,Not Hispanic or Latino,2974,70664,65.0,286,,0
2021-01-04 15:00:00,Not Hispanic or Latino,11936,82600,263.0,549,,0
2021-01-05 15:00:00,Not Hispanic or Latino,11358,93958,444.0,993,,0
2021-01-06 15:00:00,Not Hispanic or Latino,13785,107743,757.0,1750,,0
2021-01-07 15:00:00,Not Hispanic or Latino,13631,121374,1551.0,3301,,0
2021-01-08 15:00:00,Not Hispanic or Latino,14642,136016,2505.0,5806,,0
2021-01-09 15:00:00,Not Hispanic or Latino,4630,140646,839.0,6645,,0
2021-01-10 15:00:00,Not Hispanic or Latino,2533,143179,323.0,6968,,0
2021-01-11 15:00:00,Not Hispanic or Latino,12680,155859,3141.0,10109,,0
2021-01-12 15:00:00,Not Hispanic or Latino,15711,171570,4962.0,15071,,0
2021-01-13 15:00:00,Not Hispanic or Latino,17275,188845,3524.0,18595,,0
2021-01-14 15:00:00,Not Hispanic or Latino,16523,205368,1738.0,20333,,0
2021-01-15 15:00:00,Not Hispanic or Latino,17857,223225,1627.0,21960,,0
2021-01-16 15:00:00,Not Hispanic or Latino,5209,228434,1353.0,23313,,0
2021-01-17 15:00:00,Not Hispanic or Latino,1847,230281,1317.0,24630,,0
2021-01-18 15:00:00,Not Hispanic or Latino,6646,236927,2878.0,27508,,0
2021-01-19 15:00:00,Not Hispanic or Latino,16226,253153,4805.0,32313,,0
2021-01-20 15:00:00,Not Hispanic or Latino,20087,273240,4775.0,37088,,0
2021-01-21 15:00:00,Not Hispanic or Latino,22397,295637,3350.0,40438,,0
2021-01-22 15:00:00,Not Hispanic or Latino,27023,322660,3209.0,43647,,0
2021-01-23 15:00:00,Not Hispanic or Latino,9168,331828,1624.0,45271,,0
2021-01-24 15:00:00,Not Hispanic or Latino,2998,334826,1491.0,46762,,0
2021-01-25 15:00:00,Not Hispanic or Latino,15557,350383,7602.0,54364,,0
2021-01-26 15:00:00,Not Hispanic or Latino,16636,367019,8182.0,62546,,0
2021-01-27 15:00:00,Not Hispanic or Latino,23622,390641,11272.0,73818,,0
2021-01-28 15:00:00,Not Hispanic or Latino,21836,412477,8409.0,82227,,0
2021-01-29 15:00:00,Not Hispanic or Latino,24047,436524,7144.0,89371,,0
2021-01-30 15:00:00,Not Hispanic or Latino,17357,453881,2253.0,91624,,0
2021-01-31 15:00:00,Not Hispanic or Latino,3506,457387,1134.0,92758,,0
2021-03-31 15:00:00,Hispanic or Latino,3446,91639,1367.0,36892,387.0,5005
2021-04-01 15:00:00,Hispanic or Latino,2793,94432,1806.0,38698,300.0,5305
2021-04-02 15:00:00,Hispanic or Latino,2763,97195,1912.0,40610,341.0,5646
2021-04-03 15:00:00,Hispanic or Latino,2120,99315,1004.0,41614,285.0,5931
2021-04-04 15:00:00,Hispanic or Latino,696,100011,572.0,42186,49.0,5980
2021-04-05 15:00:00,Hispanic or Latino,2325,102336,1527.0,43713,363.0,6343
2021-04-06 15:00:00,Hispanic or Latino,3122,105458,1801.0,45514,514.0,6857
2021-04-07 15:00:00,Hispanic or Latino,3547,109005,1778.0,47292,873.0,7730
2021-04-08 15:00:00,Hispanic or Latino,3349,112354,1927.0,49219,1203.0,8933
2021-04-09 15:00:00,Hispanic or Latino,3270,115624,2219.0,51438,1110.0,10043
2021-04-10 15:00:00,Hispanic or Latino,2242,117866,1571.0,53009,612.0,10655
2021-04-11 15:00:00,Hispanic or Latino,2166,120032,1334.0,54343,665.0,11320
2021-04-12 15:00:00,Hispanic or Latino,2202,122234,2137.0,56480,782.0,12102
2021-04-13 15:00:00,Hispanic or Latino,3646,125880,2527.0,59007,29.0,12131
2021-04-14 15:00:00,Hispanic or Latino,4459,130339,2593.0,61600,35.0,12166
2021-04-15 15:00:00,Hispanic or Latino,3705,134044,2271.0,63871,24.0,12190
2021-04-16 15:00:00,Hispanic or Latino,3736,137780,2815.0,66686,,12190
2021-04-17 15:00:00,Hispanic or Latino,3689,141469,1848.0,68534,,12190
2021-04-18 15:00:00,Hispanic or Latino,2421,143890,1200.0,69734,,12190
2021-04-19 15:00:00,Hispanic or Latino,3406,147296,1926.0,71660,6.0,12196
2021-04-20 15:00:00,Hispanic or Latino,3641,150937,2508.0,74168,,12196
2021-04-21 15:00:00,Hispanic or Latino,5187,156124,3333.0,77501,1.0,12197
2021-04-22 15:00:00,Hispanic or Latino,4019,160143,3273.0,80774,,12197
2021-04-23 15:00:00,Hispanic or Latino,3837,163980,3075.0,83849,,12197
2021-04-24 15:00:00,Hispanic or Latino,4356,168336,2582.0,86431,8.0,12205
2021-04-25 15:00:00,Hispanic or Latino,2899,171235,825.0,87256,3.0,12208
2021-04-26 15:00:00,Hispanic or Latino,3631,174866,2438.0,89694,16.0,12224
2021-04-27 15:00:00,Hispanic or Latino,3581,178447,2595.0,92289,111.0,12335
2021-04-28 15:00:00,Hispanic or Latino,3737,182184,3682.0,95971,142.0,12477
2021-04-29 15:00:00,Hispanic or Latino,3665,185849,3129.0,99100,159.0,12636
2021-04-30 15:00:00,Hispanic or Latino,4238,190087,2755.0,101855,179.0,12815
2021-05-01 15:00:00,Hispanic or Latino,3464,193551,2305.0,104160,134.0,12949
2021-05-02 15:00:00,Hispanic or Latino,1624,195175,1627.0,105787,129.0,13078
2021-05-03 15:00:00,Hispanic or Latino,1956,197131,2220.0,108007,235.0,13313
2021-05-04 15:00:00,Hispanic or Latino,1939,199070,3199.0,111206,175.0,13488
2021-05-05 15:00:00,Hispanic or Latino,2950,202020,3873.0,115079,222.0,13710
2021-05-06 15:00:00,Hispanic or Latino,2233,204253,3494.0,118573,165.0,13875
2021-05-07 15:00:00,Hispanic or Latino,3037,207290,3668.0,122241,194.0,14069
2021-05-08 15:00:00,Hispanic or Latino,2047,209337,3227.0,125468,174.0,14243
2021-05-09 15:00:00,Hispanic or Latino,960,210297,1482.0,126950,103.0,14346
2021-05-10 15:00:00,Hispanic or Latino,1317,211614,3107.0,130057,140.0,14486
2021-05-11 15:00:00,Hispanic or Latino,1833,213447,3122.0,133179,154.0,14640
2021-05-12 15:00:00,Hispanic or Latino,2254,215701,4316.0,137495,340.0,14980
2021-05-13 15:00:00,Hispanic or Latino,2567,218268,3483.0,140978,119.0,15099
2021-05-14 15:00:00,Hispanic or Latino,3369,221637,2967.0,143945,186.0,15285
2021-05-15 15:00:00,Hispanic or Latino,3392,225029,3407.0,147352,234.0,15519
2021-05-16 15:00:00,Hispanic or Latino,1403,226432,2317.0,149669,200.0,15719
2021-05-17 15:00:00,Hispanic or Latino,1949,228381,3136.0,152805,198.0,15917
2021-05-18 15:00:00,Hispanic or Latino,2876,231257,3775.0,156580,234.0,16151
2021-05-19 15:00:00,Hispanic or Latino,4090,235347,4021.0,160601,235.0,16386
2021-05-20 15:00:00,Hispanic or Latino,3099,238446,3915.0,164516,225.0,16611
2021-05-21 15:00:00,Hispanic or Latino,2941,241387,4246.0,168762,222.0,16833
2021-05-22 15:00:00,Hispanic or Latino,3259,244646,3414.0,172176,246.0,17079
2021-05-23 15:00:00,Hispanic or Latino,1794,246440,2005.0,174181,169.0,17248
2021-05-24 15:00:00,Hispanic or Latino,2013,248453,2435.0,176616,179.0,17427
2021-05-25 15:00:00,Hispanic or Latino,2161,250614,2475.0,179091,160.0,17587
2021-05-26 15:00:00,Hispanic or Latino,2788,253402,2903.0,181994,160.0,17747
2021-05-27 15:00:00,Hispanic or Latino,1713,255115,2374.0,184368,122.0,17869
2021-05-28 15:00:00,Hispanic or Latino,2171,257286,3135.0,187503,196.0,18065
2021-05-29 15:00:00,Hispanic or Latino,2411,259697,2247.0,189750,146.0,18211
2021-05-30 15:00:00,Hispanic or Latino,1155,260852,1071.0,190821,106.0,18317
2021-02-01 15:00:00,Not Hispanic or Latino,6526,463913,4278.0,97036,,0
2021-02-02 15:00:00,Not Hispanic or Latino,11593,475506,12316.0,109352,,0
2021-02-03 15:00:00,Not Hispanic or Latino,17152,492658,16785.0,126137,,0
2021-02-04 15:00:00,Not Hispanic or Latino,20716,513374,14365.0,140502,,0
2021-02-05 15:00:00,Not Hispanic or Latino,18926,532300,15926.0,156428,,0
2021-02-06 15:00:00,Not Hispanic or Latino,11051,543351,5870.0,162298,,0
2021-02-07 15:00:00,Not Hispanic or Latino,5372,548723,1559.0,163857,,0
2021-02-08 15:00:00,Not Hispanic or Latino,11877,560600,12016.0,175873,,0
2021-02-09 15:00:00,Not Hispanic or Latino,15270,575870,12986.0,188859,,0
2021-02-10 15:00:00,Not Hispanic or Latino,17685,593555,20068.0,208927,,0
2021-02-11 15:00:00,Not Hispanic or Latino,21065,614620,16167.0,225094,,0
2021-02-12 15:00:00,Not Hispanic or Latino,18772,633392,18252.0,243346,,0
2021-02-13 15:00:00,Not Hispanic or Latino,10559,643951,5853.0,249199,,0
2021-02-14 15:00:00,Not Hispanic or Latino,6337,650288,1830.0,251029,,0
2021-02-15 15:00:00,Not Hispanic or Latino,10873,661161,12196.0,263225,,0
2021-02-16 15:00:00,Not Hispanic or Latino,15276,676437,20210.0,283435,,0
2021-02-17 15:00:00,Not Hispanic or Latino,19077,695514,25626.0,309061,,0
2021-02-18 15:00:00,Not Hispanic or Latino,2764,698278,4254.0,313315,,0
2021-02-19 15:00:00,Not Hispanic or Latino,9353,707631,18966.0,332281,,0
2021-02-20 15:00:00,Not Hispanic or Latino,9343,716974,19491.0,351772,,0
2021-02-21 15:00:00,Not Hispanic or Latino,5451,722425,7206.0,358978,,0
2021-02-22 15:00:00,Not Hispanic or Latino,7307,729732,14806.0,373784,,0
2021-02-23 15:00:00,Not Hispanic or Latino,14332,744064,15331.0,389115,,0
2021-02-24 15:00:00,Not Hispanic or Latino,16726,760790,23606.0,412721,,0
2021-02-25 15:00:00,Not Hispanic or Latino,18953,779743,25079.0,437800,,0
2021-02-26 15:00:00,Not Hispanic or Latino,24868,804611,24573.0,462373,,0
2021-02-27 15:00:00,Not Hispanic or Latino,14798,819409,10821.0,473194,,0
2021-02-28 15:00:00,Not Hispanic or Latino,14086,833495,4321.0,477515,,0
2021-03-01 15:00:00,Not Hispanic or Latino,22989,856484,11145.0,488660,,0
2021-03-02 15:00:00,Not Hispanic or Latino,21959,878443,12239.0,500899,25.0,25
2021-03-03 15:00:00,Not Hispanic or Latino,27802,906245,16889.0,517788,142.0,167
2021-03-04 15:00:00,Not Hispanic or Latino,28610,934855,16775.0,534563,3814.0,3981
2021-03-05 15:00:00,Not Hispanic or Latino,26710,961565,17970.0,552533,4603.0,8584
2021-03-06 15:00:00,Not Hispanic or Latino,16137,977702,8225.0,560758,5404.0,13988
2021-03-07 15:00:00,Not Hispanic or Latino,10920,988622,4216.0,564974,6000.0,19988
2021-03-08 15:00:00,Not Hispanic or Latino,23847,1012469,7948.0,572922,7551.0,27539
2021-03-09 15:00:00,Not Hispanic or Latino,24090,1036559,14281.0,587203,7515.0,35054
2021-03-10 15:00:00,Not Hispanic or Latino,27699,1064258,14631.0,601834,6912.0,41966
2021-03-11 15:00:00,Not Hispanic or Latino,33089,1097347,15065.0,616899,3570.0,45536
2021-03-12 15:00:00,Not Hispanic or Latino,33702,1131049,16587.0,633486,2522.0,48058
2021-03-13 15:00:00,Not Hispanic or Latino,20457,1151506,9364.0,642850,1298.0,49356
2021-03-14 15:00:00,Not Hispanic or Latino,15266,1166772,6016.0,648866,806.0,50162
2021-03-15 15:00:00,Not Hispanic or Latino,26317,1193089,10405.0,659271,500.0,50662
2021-03-16 15:00:00,Not Hispanic or Latino,29771,1222860,12314.0,671585,703.0,51365
2021-03-17 15:00:00,Not Hispanic or Latino,33429,1256289,15492.0,687077,1043.0,52408
2021-03-18 15:00:00,Not Hispanic or Latino,36956,1293245,11549.0,698626,1190.0,53598
2021-03-19 15:00:00,Not Hispanic or Latino,33946,1327191,14337.0,712963,897.0,54495
2021-03-20 15:00:00,Not Hispanic or Latino,20978,1348169,9006.0,721969,910.0,55405
2021-03-21 15:00:00,Not Hispanic or Latino,16371,1364540,6752.0,728721,280.0,55685
2021-03-22 15:00:00,Not Hispanic or Latino,28722,1393262,10422.0,739143,760.0,56445
2021-03-23 15:00:00,Not Hispanic or Latino,33102,1426364,16003.0,755146,1335.0,57780
2021-03-24 15:00:00,Not Hispanic or Latino,35263,1461627,19528.0,774674,1090.0,58870
2021-03-25 15:00:00,Not Hispanic or Latino,36431,1498058,19327.0,794001,2075.0,60945
2021-03-26 15:00:00,Not Hispanic or Latino,31423,1529481,24136.0,818137,1954.0,62899
2021-03-27 15:00:00,Not Hispanic or Latino,23473,1552954,15401.0,833538,2119.0,65018
2021-03-28 15:00:00,Not Hispanic or Latino,14047,1567001,11439.0,844977,1132.0,66150
2021-03-29 15:00:00,Not Hispanic or Latino,25122,1592123,24031.0,869008,999.0,67149
2021-03-30 15:00:00,Not Hispanic or Latino,34786,1626909,26693.0,895701,1608.0,68757
2021-05-31 15:00:00,Hispanic or Latino,301,261153,541.0,191362,43.0,18360
2021-06-01 15:00:00,Hispanic or Latino,1748,262901,2184.0,193546,155.0,18515
2021-06-02 15:00:00,Hispanic or Latino,2026,264927,2148.0,195694,123.0,18638
2021-06-03 15:00:00,Hispanic or Latino,1506,266433,2226.0,197920,122.0,18760
2021-06-04 15:00:00,Hispanic or Latino,1533,267966,3219.0,201139,132.0,18892
2021-06-05 15:00:00,Hispanic or Latino,1613,269579,2671.0,203810,122.0,19014
2021-06-06 15:00:00,Hispanic or Latino,988,270567,855.0,204665,88.0,19102
2021-06-07 15:00:00,Hispanic or Latino,1419,271986,1762.0,206427,103.0,19205
2021-06-08 15:00:00,Hispanic or Latino,1307,273293,2555.0,208982,115.0,19320
2021-06-09 15:00:00,Hispanic or Latino,1950,275243,3580.0,212562,141.0,19461
2021-06-10 15:00:00,Hispanic or Latino,1384,276627,3006.0,215568,110.0,19571
2021-06-11 15:00:00,Hispanic or Latino,1692,278319,2700.0,218268,191.0,19762
2021-06-12 15:00:00,Hispanic or Latino,1353,279672,3070.0,221338,116.0,19878
2021-06-13 15:00:00,Hispanic or Latino,557,280229,1480.0,222818,108.0,19986
2021-06-14 15:00:00,Hispanic or Latino,1261,281490,1802.0,224620,126.0,20112
2021-06-15 15:00:00,Hispanic or Latino,1039,282529,2248.0,226868,127.0,20239
2021-06-16 15:00:00,Hispanic or Latino,1412,283941,2642.0,229510,102.0,20341
2021-06-17 15:00:00,Hispanic or Latino,1377,285318,1823.0,231333,105.0,20446
2021-06-18 15:00:00,Hispanic or Latino,1383,286701,2082.0,233415,111.0,20557
2021-06-19 15:00:00,Hispanic or Latino,1075,287776,2053.0,235468,155.0,20712
2021-06-20 15:00:00,Hispanic or Latino,653,288429,1196.0,236664,131.0,20843
2021-06-21 15:00:00,Hispanic or Latino,1248,289677,813.0,237477,108.0,20951
2021-06-22 15:00:00,Hispanic or Latino,1132,290809,1662.0,239139,145.0,21096
2021-06-23 15:00:00,Hispanic or Latino,1307,292116,1900.0,241039,84.0,21180
2021-06-24 15:00:00,Hispanic or Latino,1117,293233,1273.0,242312,105.0,21285
2021-06-25 15:00:00,Hispanic or Latino,1051,294284,1431.0,243743,76.0,21361
2021-06-26 15:00:00,Hispanic or Latino,942,295226,1440.0,245183,115.0,21476
2021-06-27 15:00:00,Hispanic or Latino,724,295950,827.0,246010,64.0,21540
2021-06-28 15:00:00,Hispanic or Latino,937,296887,1222.0,247232,66.0,21606
2021-06-29 15:00:00,Hispanic or Latino,993,297880,1202.0,248434,114.0,21720
2021-06-30 15:00:00,Hispanic or Latino,1138,299018,1504.0,249938,93.0,21813
2021-07-01 15:00:00,Hispanic or Latino,914,299932,1160.0,251098,66.0,21879
2021-07-02 15:00:00,Hispanic or Latino,1129,301061,1369.0,252467,92.0,21971
2021-07-03 15:00:00,Hispanic or Latino,794,301855,878.0,253345,84.0,22055
2021-07-04 15:00:00,Hispanic or Latino,111,301966,96.0,253441,9.0,22064
2021-07-05 15:00:00,Hispanic or Latino,751,302717,813.0,254254,43.0,22107
2021-07-06 15:00:00,Hispanic or Latino,824,303541,1106.0,255360,51.0,22158
2021-07-07 15:00:00,Hispanic or Latino,874,304415,1249.0,256609,50.0,22208
2021-07-08 15:00:00,Hispanic or Latino,907,305322,1214.0,257823,71.0,22279
2021-07-09 15:00:00,Hispanic or Latino,1071,306393,1344.0,259167,80.0,22359
2021-07-10 15:00:00,Hispanic or Latino,894,307287,959.0,260126,50.0,22409
2021-07-11 15:00:00,Hispanic or Latino,848,308135,631.0,260757,77.0,22486
2021-07-12 15:00:00,Hispanic or Latino,822,308957,1079.0,261836,38.0,22524
2021-07-13 15:00:00,Hispanic or Latino,893,309850,915.0,262751,70.0,22594
2021-07-14 15:00:00,Hispanic or Latino,872,310722,1091.0,263842,55.0,22649
2021-07-15 15:00:00,Hispanic or Latino,893,311615,911.0,264753,36.0,22685
2021-07-16 15:00:00,Hispanic or Latino,994,312609,990.0,265743,73.0,22758
2021-07-17 15:00:00,Hispanic or Latino,754,313363,869.0,266612,86.0,22844
2021-07-18 15:00:00,Hispanic or Latino,456,313819,545.0,267157,30.0,22874
2021-07-19 15:00:00,Hispanic or Latino,794,314613,805.0,267962,35.0,22909
2021-07-20 15:00:00,Hispanic or Latino,861,315474,909.0,268871,37.0,22946
2021-07-21 15:00:00,Hispanic or Latino,930,316404,986.0,269857,48.0,22994
2021-07-22 15:00:00,Hispanic or Latino,842,317246,736.0,270593,28.0,23022
2021-07-23 15:00:00,Hispanic or Latino,1038,318284,936.0,271529,31.0,23053
2021-07-24 15:00:00,Hispanic or Latino,870,319154,737.0,272266,59.0,23112
2021-07-25 15:00:00,Hispanic or Latino,263,319417,115.0,272381,19.0,23131
2021-03-31 15:00:00,Not Hispanic or Latino,35095,1662004,32281.0,927982,4568.0,73325
2021-04-01 15:00:00,Not Hispanic or Latino,35438,1697442,36014.0,963996,4616.0,77941
2021-04-02 15:00:00,Not Hispanic or Latino,30145,1727587,29185.0,993181,4996.0,82937
2021-04-03 15:00:00,Not Hispanic or Latino,17783,1745370,16639.0,1009820,3488.0,86425
2021-04-04 15:00:00,Not Hispanic or Latino,6977,1752347,8869.0,1018689,854.0,87279
2021-04-05 15:00:00,Not Hispanic or Latino,23714,1776061,26106.0,1044795,5607.0,92886
2021-04-06 15:00:00,Not Hispanic or Latino,34547,1810608,27268.0,1072063,9097.0,101983
2021-04-07 15:00:00,Not Hispanic or Latino,30102,1840710,30819.0,1102882,10737.0,112720
2021-04-08 15:00:00,Not Hispanic or Latino,35969,1876679,32402.0,1135284,11160.0,123880
2021-04-09 15:00:00,Not Hispanic or Latino,27566,1904245,32747.0,1168031,12114.0,135994
2021-04-10 15:00:00,Not Hispanic or Latino,18828,1923073,20225.0,1188256,6048.0,142042
2021-04-11 15:00:00,Not Hispanic or Latino,12940,1936013,10813.0,1199069,8928.0,150970
2021-04-12 15:00:00,Not Hispanic or Latino,19760,1955773,28977.0,1228046,9081.0,160051
2021-04-13 15:00:00,Not Hispanic or Latino,35735,1991508,31819.0,1259865,277.0,160328
2021-04-14 15:00:00,Not Hispanic or Latino,32652,2024160,32837.0,1292702,160.0,160488
2021-04-15 15:00:00,Not Hispanic or Latino,33699,2057859,33508.0,1326210,112.0,160600
2021-04-16 15:00:00,Not Hispanic or Latino,29435,2087294,32345.0,1358555,10.0,160610
2021-04-17 15:00:00,Not Hispanic or Latino,24477,2111771,17185.0,1375740,4.0,160614
2021-04-18 15:00:00,Not Hispanic or Latino,14704,2126475,13269.0,1389009,3.0,160617
2021-04-19 15:00:00,Not Hispanic or Latino,22429,2148904,30040.0,1419049,44.0,160661
2021-04-20 15:00:00,Not Hispanic or Latino,23966,2172870,37085.0,1456134,35.0,160696
2021-04-21 15:00:00,Not Hispanic or Latino,30623,2203493,39547.0,1495681,14.0,160710
2021-04-22 15:00:00,Not Hispanic or Latino,28667,2232160,36504.0,1532185,14.0,160724
2021-04-23 15:00:00,Not Hispanic or Latino,25013,2257173,33745.0,1565930,9.0,160733
2021-04-24 15:00:00,Not Hispanic or Latino,18956,2276129,24068.0,1589998,67.0,160800
2021-04-25 15:00:00,Not Hispanic or Latino,13951,2290080,6760.0,1596758,22.0,160822
2021-04-26 15:00:00,Not Hispanic or Latino,20540,2310620,26851.0,1623609,173.0,160995
2021-04-27 15:00:00,Not Hispanic or Latino,20849,2331469,28722.0,1652331,906.0,161901
2021-04-28 15:00:00,Not Hispanic or Latino,23196,2354665,32986.0,1685317,1123.0,163024
2021-04-29 15:00:00,Not Hispanic or Latino,21674,2376339,32348.0,1717665,1216.0,164240
2021-04-30 15:00:00,Not Hispanic or Latino,21904,2398243,26272.0,1743937,1341.0,165581
2021-05-01 15:00:00,Not Hispanic or Latino,13428,2411671,18914.0,1762851,790.0,166371
2021-05-02 15:00:00,Not Hispanic or Latino,6355,2418026,11233.0,1774084,653.0,167024
2021-05-03 15:00:00,Not Hispanic or Latino,9881,2427907,22373.0,1796457,1580.0,168604
2021-05-04 15:00:00,Not Hispanic or Latino,11463,2439370,33037.0,1829494,1450.0,170054
2021-05-05 15:00:00,Not Hispanic or Latino,14569,2453939,29895.0,1859389,1573.0,171627
2021-05-06 15:00:00,Not Hispanic or Latino,13311,2467250,32703.0,1892092,1444.0,173071
2021-05-07 15:00:00,Not Hispanic or Latino,12850,2480100,28259.0,1920351,1628.0,174699
2021-05-08 15:00:00,Not Hispanic or Latino,7446,2487546,23336.0,1943687,1004.0,175703
2021-05-09 15:00:00,Not Hispanic or Latino,3418,2490964,8814.0,1952501,554.0,176257
2021-05-10 15:00:00,Not Hispanic or Latino,6661,2497625,23307.0,1975808,1133.0,177390
2021-05-11 15:00:00,Not Hispanic or Latino,9590,2507215,24669.0,2000477,1202.0,178592
2021-05-12 15:00:00,Not Hispanic or Latino,10577,2517792,30183.0,2030660,1398.0,179990
2021-05-13 15:00:00,Not Hispanic or Latino,18167,2535959,27465.0,2058125,1090.0,181080
2021-05-14 15:00:00,Not Hispanic or Latino,19537,2555496,23271.0,2081396,1393.0,182473
2021-05-15 15:00:00,Not Hispanic or Latino,16401,2571897,17337.0,2098733,1040.0,183513
2021-05-16 15:00:00,Not Hispanic or Latino,7075,2578972,13016.0,2111749,709.0,184222
2021-05-17 15:00:00,Not Hispanic or Latino,13724,2592696,20851.0,2132600,1514.0,185736
2021-05-18 15:00:00,Not Hispanic or Latino,17153,2609849,24148.0,2156748,1513.0,187249
2021-05-19 15:00:00,Not Hispanic or Latino,22234,2632083,25703.0,2182451,1220.0,188469
2021-05-20 15:00:00,Not Hispanic or Latino,15768,2647851,26039.0,2208490,1561.0,190030
2021-05-21 15:00:00,Not Hispanic or Latino,15274,2663125,23573.0,2232063,1192.0,191222
2021-05-22 15:00:00,Not Hispanic or Latino,11534,2674659,14489.0,2246552,782.0,192004
2021-05-23 15:00:00,Not Hispanic or Latino,6300,2680959,8050.0,2254602,596.0,192600
2021-05-24 15:00:00,Not Hispanic or Latino,10295,2691254,13465.0,2268067,1066.0,193666
2021-05-25 15:00:00,Not Hispanic or Latino,9944,2701198,15349.0,2283416,1026.0,194692
2021-05-26 15:00:00,Not Hispanic or Latino,14507,2715705,15320.0,2298736,1163.0,195855
2021-05-27 15:00:00,Not Hispanic or Latino,8921,2724626,14475.0,2313211,868.0,196723
2021-05-28 15:00:00,Not Hispanic or Latino,9292,2733918,14820.0,2328031,1022.0,197745
2021-05-29 15:00:00,Not Hispanic or Latino,6141,2740059,7718.0,2335749,551.0,198296
2021-05-30 15:00:00,Not Hispanic or Latino,3368,2743427,4512.0,2340261,351.0,198647
2021-05-31 15:00:00,Not Hispanic or Latino,1190,2744617,2651.0,2342912,185.0,198832
2021-06-01 15:00:00,Not Hispanic or Latino,6994,2751611,13188.0,2356100,838.0,199670
2021-06-02 15:00:00,Not Hispanic or Latino,7513,2759124,13525.0,2369625,744.0,200414
2021-06-03 15:00:00,Not Hispanic or Latino,6004,2765128,17809.0,2387434,853.0,201267
2021-06-04 15:00:00,Not Hispanic or Latino,6241,2771369,17687.0,2405121,851.0,202118
2021-06-05 15:00:00,Not Hispanic or Latino,4925,2776294,15410.0,2420531,547.0,202665
2021-06-06 15:00:00,Not Hispanic or Latino,2247,2778541,5795.0,2426326,258.0,202923
2021-06-07 15:00:00,Not Hispanic or Latino,5050,2783591,13432.0,2439758,568.0,203491
2021-06-08 15:00:00,Not Hispanic or Latino,5034,2788625,16240.0,2455998,613.0,204104
2021-06-09 15:00:00,Not Hispanic or Latino,5724,2794349,19220.0,2475218,744.0,204848
2021-06-10 15:00:00,Not Hispanic or Latino,5348,2799697,15083.0,2490301,708.0,205556
2021-06-11 15:00:00,Not Hispanic or Latino,5224,2804921,13891.0,2504192,818.0,206374
2021-06-12 15:00:00,Not Hispanic or Latino,3425,2808346,10461.0,2514653,402.0,206776
2021-06-13 15:00:00,Not Hispanic or Latino,1161,2809507,5543.0,2520196,261.0,207037
2021-06-14 15:00:00,Not Hispanic or Latino,4081,2813588,9498.0,2529694,529.0,207566
2021-06-15 15:00:00,Not Hispanic or Latino,4158,2817746,11140.0,2540834,602.0,208168
2021-06-16 15:00:00,Not Hispanic or Latino,4878,2822624,14413.0,2555247,523.0,208691
2021-06-17 15:00:00,Not Hispanic or Latino,4832,2827456,9623.0,2564870,505.0,209196
2021-06-18 15:00:00,Not Hispanic or Latino,4701,2832157,9272.0,2574142,508.0,209704
2021-06-19 15:00:00,Not Hispanic or Latino,2873,2835030,5902.0,2580044,403.0,210107
2021-06-20 15:00:00,Not Hispanic or Latino,1336,2836366,3049.0,2583093,211.0,210318
2021-06-21 15:00:00,Not Hispanic or Latino,3904,2840270,4121.0,2587214,489.0,210807
2021-06-22 15:00:00,Not Hispanic or Latino,3644,2843914,6605.0,2593819,438.0,211245
2021-06-23 15:00:00,Not Hispanic or Latino,4308,2848222,7790.0,2601609,490.0,211735
2021-06-24 15:00:00,Not Hispanic or Latino,4094,2852316,6147.0,2607756,429.0,212164
2021-06-25 15:00:00,Not Hispanic or Latino,3878,2856194,5980.0,2613736,475.0,212639
2021-06-26 15:00:00,Not Hispanic or Latino,2474,2858668,4378.0,2618114,204.0,212843
2021-06-27 15:00:00,Not Hispanic or Latino,1639,2860307,2315.0,2620429,101.0,212944
2021-06-28 15:00:00,Not Hispanic or Latino,3266,2863573,4365.0,2624794,417.0,213361
2021-06-29 15:00:00,Not Hispanic or Latino,3636,2867209,4891.0,2629685,335.0,213696
2021-06-30 15:00:00,Not Hispanic or Latino,4054,2871263,5496.0,2635181,461.0,214157
2021-07-01 15:00:00,Not Hispanic or Latino,3625,2874888,4977.0,2640158,344.0,214501
2021-07-02 15:00:00,Not Hispanic or Latino,3563,2878451,4745.0,2644903,371.0,214872
2021-07-03 15:00:00,Not Hispanic or Latino,2073,2880524,2753.0,2647656,149.0,215021
2021-07-04 15:00:00,Not Hispanic or Latino,269,2880793,329.0,2647985,46.0,215067
2021-07-05 15:00:00,Not Hispanic or Latino,2606,2883399,2913.0,2650898,220.0,215287
2021-07-06 15:00:00,Not Hispanic or Latino,3248,2886647,4729.0,2655627,322.0,215609
2021-07-07 15:00:00,Not Hispanic or Latino,3221,2889868,4741.0,2660368,347.0,215956
2021-07-08 15:00:00,Not Hispanic or Latino,3344,2893212,4322.0,2664690,358.0,216314
2021-07-09 15:00:00,Not Hispanic or Latino,3763,2896975,4635.0,2669325,382.0,216696
2021-07-10 15:00:00,Not Hispanic or Latino,2322,2899297,2865.0,2672190,205.0,216901
2021-07-11 15:00:00,Not Hispanic or Latino,1421,2900718,1483.0,2673673,121.0,217022
2021-07-12 15:00:00,Not Hispanic or Latino,3276,2903994,3749.0,2677422,308.0,217330
2021-07-13 15:00:00,Not Hispanic or Latino,3456,2907450,3357.0,2680779,258.0,217588
2021-07-14 15:00:00,Not Hispanic or Latino,3296,2910746,3789.0,2684568,310.0,217898
2021-07-15 15:00:00,Not Hispanic or Latino,3473,2914219,3631.0,2688199,263.0,218161
2021-07-16 15:00:00,Not Hispanic or Latino,3998,2918217,3764.0,2691963,247.0,218408
2021-07-17 15:00:00,Not Hispanic or Latino,2285,2920502,2302.0,2694265,177.0,218585
2021-07-18 15:00:00,Not Hispanic or Latino,1472,2921974,1379.0,2695644,63.0,218648
2021-07-19 15:00:00,Not Hispanic or Latino,3944,2925918,3305.0,2698949,303.0,218951
2021-07-20 15:00:00,Not Hispanic or Latino,3935,2929853,3411.0,2702360,259.0,219210
2021-07-21 15:00:00,Not Hispanic or Latino,4176,2934029,3509.0,2705869,309.0,219519
2021-07-22 15:00:00,Not Hispanic or Latino,4352,2938381,3297.0,2709166,298.0,219817
2021-07-23 15:00:00,Not Hispanic or Latino,4684,2943065,3180.0,2712346,309.0,220126
2021-07-24 15:00:00,Not Hispanic or Latino,2628,2945693,2106.0,2714452,97.0,220223
2021-07-25 15:00:00,Not Hispanic or Latino,641,2946334,251.0,2714703,37.0,220260
