VACCINATION_DATE,Ethnicity,FirstDoseDaily,FirstDoseCumulative,SecondDoseDaily,SecondDoseCumulative,SingleDoseDaily,SingleDoseCumulative
2020-12-14 15:00:00,Unknown,1,1,,0,,0
2020-12-16 15:00:00,Unknown,10,11,,0,,0
2020-12-17 15:00:00,Unknown,17,28,,0,,0
2020-12-18 15:00:00,Unknown,90,118,,0,,0
2020-12-19 15:00:00,Unknown,27,145,,0,,0
2020-12-20 15:00:00,Unknown,29,174,,0,,0
2020-12-21 15:00:00,Unknown,69,243,,0,,0
2020-12-22 15:00:00,Unknown,400,643,,0,,0
2020-12-23 15:00:00,Unknown,187,830,,0,,0
2020-12-24 15:00:00,Unknown,61,891,,0,,0
2020-12-25 15:00:00,Unknown,180,1071,,0,,0
2020-12-26 15:00:00,Unknown,198,1269,,0,,0
2020-12-27 15:00:00,Unknown,143,1412,,0,,0
2020-12-28 15:00:00,Unknown,272,1684,,0,,0
2020-12-29 15:00:00,Unknown,459,2143,,0,,0
2020-12-30 15:00:00,Unknown,368,2511,,0,,0
2020-12-31 15:00:00,Unknown,216,2727,,0,,0
2021-01-01 15:00:00,Unknown,149,2876,2.0,2,,0
2021-01-02 15:00:00,Unknown,164,3040,2.0,4,,0
2021-01-03 15:00:00,Unknown,230,3270,4.0,8,,0
2021-01-04 15:00:00,Unknown,588,3858,6.0,14,,0
2021-01-05 15:00:00,Unknown,509,4367,18.0,32,,0
2021-01-06 15:00:00,Unknown,654,5021,22.0,54,,0
2021-01-07 15:00:00,Unknown,416,5437,55.0,109,,0
2021-01-08 15:00:00,Unknown,8305,13742,71.0,180,,0
2021-01-09 15:00:00,Unknown,222,13964,39.0,219,,0
2021-01-10 15:00:00,Unknown,179,14143,9.0,228,,0
2021-01-11 15:00:00,Unknown,328,14471,75.0,303,,0
2021-01-12 15:00:00,Unknown,704,15175,334.0,637,,0
2021-01-13 15:00:00,Unknown,406,15581,129.0,766,,0
2021-01-14 15:00:00,Unknown,389,15970,61.0,827,,0
2021-01-15 15:00:00,Unknown,531,16501,179.0,1006,,0
2021-01-16 15:00:00,Unknown,289,16790,159.0,1165,,0
2021-01-17 15:00:00,Unknown,110,16900,97.0,1262,,0
2021-01-18 15:00:00,Unknown,177,17077,198.0,1460,,0
2021-01-19 15:00:00,Unknown,297,17374,250.0,1710,,0
2021-01-20 15:00:00,Unknown,371,17745,167.0,1877,,0
2021-01-21 15:00:00,Unknown,461,18206,94.0,1971,,0
2021-01-22 15:00:00,Unknown,700,18906,166.0,2137,,0
2021-01-23 15:00:00,Unknown,419,19325,143.0,2280,,0
2021-01-24 15:00:00,Unknown,198,19523,150.0,2430,,0
2021-01-25 15:00:00,Unknown,548,20071,464.0,2894,,0
2021-01-26 15:00:00,Unknown,633,20704,369.0,3263,,0
2021-01-27 15:00:00,Unknown,500,21204,532.0,3795,,0
2021-01-28 15:00:00,Unknown,476,21680,270.0,4065,,0
2021-01-29 15:00:00,Unknown,505,22185,202.0,4267,,0
2021-01-30 15:00:00,Unknown,291,22476,49.0,4316,,0
2021-01-31 15:00:00,Unknown,344,22820,82.0,4398,,0
2021-02-01 15:00:00,Unknown,426,23246,196.0,4594,,0
2021-02-02 15:00:00,Unknown,574,23820,636.0,5230,,0
2021-02-03 15:00:00,Unknown,700,24520,471.0,5701,,0
2021-02-04 15:00:00,Unknown,836,25356,411.0,6112,,0
2021-02-05 15:00:00,Unknown,661,26017,414.0,6526,,0
2021-02-06 15:00:00,Unknown,384,26401,8205.0,14731,,0
2021-02-07 15:00:00,Unknown,375,26776,91.0,14822,,0
2021-04-13 15:00:00,Federal Entities,84295,84295,54201.0,54201,2952.0,2952
2021-04-14 15:00:00,Federal Entities,557,84852,11.0,54212,1.0,2953
2021-04-15 15:00:00,Federal Entities,623,85475,823.0,55035,19.0,2972
2021-04-16 15:00:00,Federal Entities,782,86257,1016.0,56051,8.0,2980
2021-04-17 15:00:00,Federal Entities,1136,87393,1177.0,57228,6.0,2986
2021-04-19 15:00:00,Federal Entities,1369,88762,2003.0,59231,9.0,2995
2021-04-20 15:00:00,Federal Entities,3243,92005,2158.0,61389,19.0,3014
2021-04-21 15:00:00,Federal Entities,906,92911,1206.0,62595,4.0,3018
2021-04-22 15:00:00,Federal Entities,1018,93929,458.0,63053,,3018
2021-04-23 15:00:00,Federal Entities,759,94688,632.0,63685,1.0,3019
2021-04-25 15:00:00,Federal Entities,992,95680,2492.0,66177,5.0,3024
2021-04-26 15:00:00,Federal Entities,1483,97163,1672.0,67849,1.0,3025
2021-04-29 15:00:00,Federal Entities,223,97386,865.0,68714,2.0,3027
2021-05-01 15:00:00,Federal Entities,1556,98942,1974.0,70688,14.0,3041
2021-05-02 15:00:00,Federal Entities,1071,100013,1875.0,72563,4.0,3045
2021-05-03 15:00:00,Federal Entities,403,100416,2165.0,74728,4.0,3049
2021-05-04 15:00:00,Federal Entities,28,100444,25.0,74753,,3049
2021-05-05 15:00:00,Federal Entities,365,100809,814.0,75567,,3049
2021-05-06 15:00:00,Federal Entities,275,101084,880.0,76447,3.0,3052
2021-05-07 15:00:00,Federal Entities,274,101358,966.0,77413,8.0,3060
2021-05-08 15:00:00,Federal Entities,297,101655,1312.0,78725,6.0,3066
2021-05-10 15:00:00,Federal Entities,338,101993,1712.0,80437,1.0,3067
2021-05-11 15:00:00,Federal Entities,18,102011,13.0,80450,,3067
2021-05-12 15:00:00,Federal Entities,243,102254,1124.0,81574,,3067
2021-05-14 15:00:00,Federal Entities,290,102544,1022.0,82596,2.0,3069
2021-05-15 15:00:00,Federal Entities,611,103155,1701.0,84297,4.0,3073
2021-05-17 15:00:00,Federal Entities,565,103720,2505.0,86802,11.0,3084
2021-05-18 15:00:00,Federal Entities,164,103884,61.0,86863,2.0,3086
2021-05-20 15:00:00,Federal Entities,885,104769,1024.0,87887,,3086
2021-05-22 15:00:00,Federal Entities,911,105680,1359.0,89246,9.0,3095
2021-05-24 15:00:00,Federal Entities,514,106194,1032.0,90278,8.0,3103
2021-05-25 15:00:00,Federal Entities,5,106199,1.0,90279,2.0,3105
2021-05-27 15:00:00,Federal Entities,425,106624,674.0,90953,1.0,3106
2021-05-28 15:00:00,Federal Entities,418,107042,342.0,91295,,3106
2021-05-29 15:00:00,Federal Entities,267,107309,344.0,91639,10.0,3116
2021-05-31 15:00:00,Federal Entities,214,107523,243.0,91882,3.0,3119
2021-06-01 15:00:00,Federal Entities,30,107553,48.0,91930,,3119
2020-12-15 15:00:00,Hispanic or Latino,3,3,,0,,0
2020-12-16 15:00:00,Hispanic or Latino,18,21,,0,,0
2020-12-17 15:00:00,Hispanic or Latino,37,58,,0,,0
2020-12-18 15:00:00,Hispanic or Latino,85,143,,0,,0
2020-12-19 15:00:00,Hispanic or Latino,37,180,,0,,0
2020-12-20 15:00:00,Hispanic or Latino,10,190,,0,,0
2020-12-21 15:00:00,Hispanic or Latino,148,338,1.0,1,,0
2020-12-22 15:00:00,Hispanic or Latino,256,594,,1,,0
2020-12-23 15:00:00,Hispanic or Latino,184,778,1.0,2,,0
2020-12-24 15:00:00,Hispanic or Latino,90,868,,2,,0
2020-12-25 15:00:00,Hispanic or Latino,40,908,,2,,0
2020-12-26 15:00:00,Hispanic or Latino,39,947,,2,,0
2020-12-27 15:00:00,Hispanic or Latino,59,1006,,2,,0
2020-12-28 15:00:00,Hispanic or Latino,259,1265,1.0,3,,0
2020-12-29 15:00:00,Hispanic or Latino,361,1626,2.0,5,,0
2020-12-30 15:00:00,Hispanic or Latino,505,2131,2.0,7,,0
2020-12-31 15:00:00,Hispanic or Latino,326,2457,2.0,9,,0
2021-01-01 15:00:00,Hispanic or Latino,56,2513,6.0,15,,0
2021-01-02 15:00:00,Hispanic or Latino,83,2596,2.0,17,,0
2021-01-03 15:00:00,Hispanic or Latino,116,2712,3.0,20,,0
2021-01-04 15:00:00,Hispanic or Latino,614,3326,12.0,32,,0
2021-02-08 15:00:00,Unknown,682,27458,251.0,15073,,0
2021-02-09 15:00:00,Unknown,729,28187,299.0,15372,,0
2021-02-10 15:00:00,Unknown,787,28974,420.0,15792,,0
2021-02-11 15:00:00,Unknown,867,29841,403.0,16195,,0
2021-02-12 15:00:00,Unknown,741,30582,546.0,16741,,0
2021-02-13 15:00:00,Unknown,405,30987,157.0,16898,,0
2021-02-14 15:00:00,Unknown,440,31427,122.0,17020,,0
2021-02-15 15:00:00,Unknown,450,31877,525.0,17545,,0
2021-02-16 15:00:00,Unknown,704,32581,668.0,18213,,0
2021-02-17 15:00:00,Unknown,795,33376,471.0,18684,,0
2021-02-18 15:00:00,Unknown,262,33638,247.0,18931,,0
2021-02-19 15:00:00,Unknown,558,34196,457.0,19388,,0
2021-02-20 15:00:00,Unknown,585,34781,394.0,19782,,0
2021-02-21 15:00:00,Unknown,345,35126,323.0,20105,,0
2021-02-22 15:00:00,Unknown,426,35552,412.0,20517,,0
2021-02-23 15:00:00,Unknown,635,36187,393.0,20910,,0
2021-02-24 15:00:00,Unknown,606,36793,499.0,21409,,0
2021-02-25 15:00:00,Unknown,604,37397,804.0,22213,,0
2021-02-26 15:00:00,Unknown,744,38141,761.0,22974,,0
2021-02-27 15:00:00,Unknown,552,38693,295.0,23269,,0
2021-02-28 15:00:00,Unknown,631,39324,205.0,23474,,0
2021-03-01 15:00:00,Unknown,825,40149,477.0,23951,,0
2021-03-02 15:00:00,Unknown,762,40911,526.0,24477,1.0,1
2021-03-03 15:00:00,Unknown,953,41864,585.0,25062,3.0,4
2021-03-04 15:00:00,Unknown,931,42795,676.0,25738,103.0,107
2021-03-05 15:00:00,Unknown,964,43759,555.0,26293,87.0,194
2021-03-06 15:00:00,Unknown,643,44402,299.0,26592,189.0,383
2021-03-07 15:00:00,Unknown,519,44921,331.0,26923,296.0,679
2021-03-08 15:00:00,Unknown,893,45814,345.0,27268,356.0,1035
2021-03-09 15:00:00,Unknown,866,46680,448.0,27716,370.0,1405
2021-03-10 15:00:00,Unknown,793,47473,483.0,28199,491.0,1896
2021-03-11 15:00:00,Unknown,951,48424,509.0,28708,190.0,2086
2021-03-12 15:00:00,Unknown,1169,49593,608.0,29316,162.0,2248
2021-03-13 15:00:00,Unknown,845,50438,368.0,29684,75.0,2323
2021-03-14 15:00:00,Unknown,1021,51459,351.0,30035,70.0,2393
2021-03-15 15:00:00,Unknown,1619,53078,399.0,30434,35.0,2428
2021-03-16 15:00:00,Unknown,1579,54657,585.0,31019,45.0,2473
2021-03-17 15:00:00,Unknown,1590,56247,670.0,31689,63.0,2536
2021-03-18 15:00:00,Unknown,1749,57996,446.0,32135,58.0,2594
2021-03-19 15:00:00,Unknown,1436,59432,424.0,32559,56.0,2650
2021-03-20 15:00:00,Unknown,1273,60705,434.0,32993,37.0,2687
2021-03-21 15:00:00,Unknown,1090,61795,475.0,33468,24.0,2711
2021-03-22 15:00:00,Unknown,1545,63340,490.0,33958,32.0,2743
2021-03-23 15:00:00,Unknown,1964,65304,601.0,34559,75.0,2818
2021-03-24 15:00:00,Unknown,2567,67871,523.0,35082,74.0,2892
2021-03-25 15:00:00,Unknown,2589,70460,586.0,35668,323.0,3215
2021-03-26 15:00:00,Unknown,2573,73033,674.0,36342,356.0,3571
2021-03-27 15:00:00,Unknown,1844,74877,506.0,36848,398.0,3969
2021-03-28 15:00:00,Unknown,1893,76770,499.0,37347,420.0,4389
2021-03-29 15:00:00,Unknown,2638,79408,938.0,38285,75.0,4464
2021-03-30 15:00:00,Unknown,2498,81906,976.0,39261,124.0,4588
2021-03-31 15:00:00,Unknown,2486,84392,843.0,40104,797.0,5385
2021-04-01 15:00:00,Unknown,1822,86214,973.0,41077,623.0,6008
2021-04-02 15:00:00,Unknown,1866,88080,1261.0,42338,741.0,6749
2021-04-03 15:00:00,Unknown,1645,89725,835.0,43173,662.0,7411
2021-04-04 15:00:00,Unknown,602,90327,649.0,43822,48.0,7459
2021-04-05 15:00:00,Unknown,1856,92183,1103.0,44925,664.0,8123
2021-04-06 15:00:00,Unknown,2180,94363,1241.0,46166,877.0,9000
2021-04-07 15:00:00,Unknown,2428,96791,1327.0,47493,1325.0,10325
2021-04-08 15:00:00,Unknown,3039,99830,1494.0,48987,1492.0,11817
2021-04-09 15:00:00,Unknown,3269,103099,1057.0,50044,1271.0,13088
2021-04-10 15:00:00,Unknown,2762,105861,1051.0,51095,978.0,14066
2021-04-11 15:00:00,Unknown,2471,108332,1065.0,52160,851.0,14917
2021-04-12 15:00:00,Unknown,2772,111104,1845.0,54005,1069.0,15986
2021-04-13 15:00:00,Unknown,3258,114362,1885.0,55890,33.0,16019
2021-04-14 15:00:00,Unknown,3122,117484,2133.0,58023,10.0,16029
2021-04-15 15:00:00,Unknown,3747,121231,2290.0,60313,14.0,16043
2021-04-16 15:00:00,Unknown,3354,124585,2348.0,62661,2.0,16045
2021-04-17 15:00:00,Unknown,3671,128256,1633.0,64294,1.0,16046
2021-04-18 15:00:00,Unknown,2908,131164,1677.0,65971,,16046
2021-04-19 15:00:00,Unknown,2765,133929,2403.0,68374,3.0,16049
2021-04-20 15:00:00,Unknown,2258,136187,2159.0,70533,,16049
2021-04-21 15:00:00,Unknown,3022,139209,2485.0,73018,,16049
2021-04-22 15:00:00,Unknown,2715,141924,1280.0,74298,,16049
2021-04-23 15:00:00,Unknown,3179,145103,1958.0,76256,2.0,16051
2021-04-24 15:00:00,Unknown,3087,148190,1529.0,77785,3.0,16054
2021-04-25 15:00:00,Unknown,2379,150569,763.0,78548,,16054
2021-04-26 15:00:00,Unknown,1760,152329,1515.0,80063,11.0,16065
2021-04-27 15:00:00,Unknown,2309,154638,1445.0,81508,81.0,16146
2021-04-28 15:00:00,Unknown,2067,156705,2545.0,84053,94.0,16240
2021-04-29 15:00:00,Unknown,1829,158534,2681.0,86734,81.0,16321
2021-04-30 15:00:00,Unknown,1954,160488,2746.0,89480,110.0,16431
2021-05-01 15:00:00,Unknown,1571,162059,2578.0,92058,56.0,16487
2021-05-02 15:00:00,Unknown,1213,163272,2227.0,94285,34.0,16521
2021-05-03 15:00:00,Unknown,764,164036,2744.0,97029,87.0,16608
2021-05-04 15:00:00,Unknown,762,164798,2999.0,100028,102.0,16710
2021-05-05 15:00:00,Unknown,1409,166207,2930.0,102958,115.0,16825
2021-05-06 15:00:00,Unknown,1204,167411,3283.0,106241,93.0,16918
2021-05-07 15:00:00,Unknown,1245,168656,2839.0,109080,105.0,17023
2021-05-08 15:00:00,Unknown,1010,169666,3171.0,112251,106.0,17129
2021-05-09 15:00:00,Unknown,692,170358,1532.0,113783,35.0,17164
2021-05-10 15:00:00,Unknown,619,170977,2869.0,116652,82.0,17246
2021-05-11 15:00:00,Unknown,736,171713,2320.0,118972,81.0,17327
2021-05-12 15:00:00,Unknown,888,172601,2734.0,121706,156.0,17483
2021-05-13 15:00:00,Unknown,1065,173666,2335.0,124041,140.0,17623
2021-05-14 15:00:00,Unknown,1214,174880,2366.0,126407,186.0,17809
2021-05-15 15:00:00,Unknown,1438,176318,2466.0,128873,235.0,18044
2021-05-16 15:00:00,Unknown,568,176886,2124.0,130997,199.0,18243
2021-05-17 15:00:00,Unknown,648,177534,1728.0,132725,225.0,18468
2021-05-18 15:00:00,Unknown,1080,178614,2564.0,135289,189.0,18657
2021-05-19 15:00:00,Unknown,1336,179950,2504.0,137793,167.0,18824
2021-05-20 15:00:00,Unknown,1134,181084,2108.0,139901,171.0,18995
2021-05-21 15:00:00,Unknown,1225,182309,2077.0,141978,195.0,19190
2021-05-22 15:00:00,Unknown,1252,183561,1218.0,143196,228.0,19418
2021-05-23 15:00:00,Unknown,743,184304,1272.0,144468,191.0,19609
2021-05-24 15:00:00,Unknown,763,185067,820.0,145288,222.0,19831
2021-01-05 15:00:00,Hispanic or Latino,405,3731,19.0,51,,0
2021-01-06 15:00:00,Hispanic or Latino,581,4312,19.0,70,,0
2021-01-07 15:00:00,Hispanic or Latino,800,5112,61.0,131,,0
2021-01-08 15:00:00,Hispanic or Latino,872,5984,92.0,223,,0
2021-01-09 15:00:00,Hispanic or Latino,194,6178,33.0,256,,0
2021-01-10 15:00:00,Hispanic or Latino,138,6316,21.0,277,,0
2021-01-11 15:00:00,Hispanic or Latino,548,6864,130.0,407,,0
2021-01-12 15:00:00,Hispanic or Latino,738,7602,206.0,613,,0
2021-01-13 15:00:00,Hispanic or Latino,677,8279,132.0,745,,0
2021-01-14 15:00:00,Hispanic or Latino,743,9022,67.0,812,,0
2021-01-15 15:00:00,Hispanic or Latino,874,9896,67.0,879,,0
2021-01-16 15:00:00,Hispanic or Latino,180,10076,42.0,921,,0
2021-01-17 15:00:00,Hispanic or Latino,99,10175,41.0,962,,0
2021-01-18 15:00:00,Hispanic or Latino,171,10346,108.0,1070,,0
2021-01-19 15:00:00,Hispanic or Latino,471,10817,160.0,1230,,0
2021-01-20 15:00:00,Hispanic or Latino,628,11445,182.0,1412,,0
2021-01-21 15:00:00,Hispanic or Latino,758,12203,124.0,1536,,0
2021-01-22 15:00:00,Hispanic or Latino,961,13164,106.0,1642,,0
2021-01-23 15:00:00,Hispanic or Latino,331,13495,54.0,1696,,0
2021-01-24 15:00:00,Hispanic or Latino,97,13592,37.0,1733,,0
2021-01-25 15:00:00,Hispanic or Latino,373,13965,303.0,2036,,0
2021-01-26 15:00:00,Hispanic or Latino,496,14461,226.0,2262,,0
2021-01-27 15:00:00,Hispanic or Latino,743,15204,438.0,2700,,0
2021-01-28 15:00:00,Hispanic or Latino,793,15997,390.0,3090,,0
2021-01-29 15:00:00,Hispanic or Latino,709,16706,296.0,3386,,0
2021-01-30 15:00:00,Hispanic or Latino,504,17210,91.0,3477,,0
2021-01-31 15:00:00,Hispanic or Latino,132,17342,29.0,3506,,0
2021-02-01 15:00:00,Hispanic or Latino,171,17513,153.0,3659,,0
2021-02-02 15:00:00,Hispanic or Latino,419,17932,593.0,4252,,0
2021-02-03 15:00:00,Hispanic or Latino,601,18533,668.0,4920,,0
2021-02-04 15:00:00,Hispanic or Latino,740,19273,716.0,5636,,0
2021-02-05 15:00:00,Hispanic or Latino,760,20033,867.0,6503,,0
2021-02-06 15:00:00,Hispanic or Latino,388,20421,204.0,6707,,0
2021-02-07 15:00:00,Hispanic or Latino,165,20586,64.0,6771,,0
2021-02-08 15:00:00,Hispanic or Latino,531,21117,605.0,7376,,0
2021-02-09 15:00:00,Hispanic or Latino,547,21664,514.0,7890,,0
2021-02-10 15:00:00,Hispanic or Latino,702,22366,691.0,8581,,0
2021-02-11 15:00:00,Hispanic or Latino,855,23221,718.0,9299,,0
2021-02-12 15:00:00,Hispanic or Latino,778,23999,850.0,10149,,0
2021-02-13 15:00:00,Hispanic or Latino,362,24361,219.0,10368,,0
2021-02-14 15:00:00,Hispanic or Latino,277,24638,64.0,10432,,0
2021-02-15 15:00:00,Hispanic or Latino,315,24953,363.0,10795,,0
2021-02-16 15:00:00,Hispanic or Latino,511,25464,537.0,11332,,0
2021-02-17 15:00:00,Hispanic or Latino,698,26162,741.0,12073,,0
2021-02-18 15:00:00,Hispanic or Latino,116,26278,132.0,12205,,0
2021-02-19 15:00:00,Hispanic or Latino,372,26650,748.0,12953,,0
2021-02-20 15:00:00,Hispanic or Latino,371,27021,632.0,13585,,0
2021-02-21 15:00:00,Hispanic or Latino,311,27332,243.0,13828,,0
2021-02-22 15:00:00,Hispanic or Latino,292,27624,418.0,14246,,0
2021-02-23 15:00:00,Hispanic or Latino,526,28150,484.0,14730,,0
2021-02-24 15:00:00,Hispanic or Latino,567,28717,810.0,15540,,0
2021-02-25 15:00:00,Hispanic or Latino,776,29493,815.0,16355,,0
2021-02-26 15:00:00,Hispanic or Latino,1125,30618,836.0,17191,,0
2021-02-27 15:00:00,Hispanic or Latino,672,31290,343.0,17534,,0
2021-02-28 15:00:00,Hispanic or Latino,730,32020,179.0,17713,,0
2021-03-01 15:00:00,Hispanic or Latino,1125,33145,418.0,18131,,0
2021-03-02 15:00:00,Hispanic or Latino,1051,34196,350.0,18481,1.0,1
2021-03-03 15:00:00,Hispanic or Latino,1162,35358,655.0,19136,13.0,14
2021-03-04 15:00:00,Hispanic or Latino,1352,36710,496.0,19632,149.0,163
2021-03-05 15:00:00,Hispanic or Latino,1658,38368,605.0,20237,202.0,365
2021-03-06 15:00:00,Hispanic or Latino,903,39271,274.0,20511,384.0,749
2021-03-07 15:00:00,Hispanic or Latino,580,39851,196.0,20707,287.0,1036
2021-03-08 15:00:00,Hispanic or Latino,1204,41055,305.0,21012,364.0,1400
2021-05-25 15:00:00,Unknown,902,185969,831.0,146119,140.0,19971
2021-05-26 15:00:00,Unknown,1053,187022,1106.0,147225,180.0,20151
2021-05-27 15:00:00,Unknown,780,187802,975.0,148200,125.0,20276
2021-05-28 15:00:00,Unknown,832,188634,1228.0,149428,177.0,20453
2021-05-29 15:00:00,Unknown,866,189500,1230.0,150658,226.0,20679
2021-05-30 15:00:00,Unknown,455,189955,860.0,151518,136.0,20815
2021-05-31 15:00:00,Unknown,96,190051,202.0,151720,72.0,20887
2021-06-01 15:00:00,Unknown,702,190753,898.0,152618,130.0,21017
2021-06-02 15:00:00,Unknown,675,191428,996.0,153614,77.0,21094
2021-06-03 15:00:00,Unknown,537,191965,979.0,154593,91.0,21185
2021-06-04 15:00:00,Unknown,583,192548,1092.0,155685,64.0,21249
2021-06-05 15:00:00,Unknown,620,193168,1153.0,156838,43.0,21292
2021-06-06 15:00:00,Unknown,268,193436,464.0,157302,54.0,21346
2021-06-07 15:00:00,Unknown,452,193888,421.0,157723,48.0,21394
2021-06-08 15:00:00,Unknown,499,194387,737.0,158460,79.0,21473
2021-06-09 15:00:00,Unknown,642,195029,923.0,159383,59.0,21532
2021-06-10 15:00:00,Unknown,531,195560,829.0,160212,69.0,21601
2021-06-11 15:00:00,Unknown,605,196165,765.0,160977,102.0,21703
2021-06-12 15:00:00,Unknown,672,196837,1031.0,162008,96.0,21799
2021-06-13 15:00:00,Unknown,296,197133,454.0,162462,51.0,21850
2021-06-14 15:00:00,Unknown,80,197213,107.0,162569,40.0,21890
2020-12-14 15:00:00,Not Hispanic or Latino,6,6,,0,,0
2020-12-15 15:00:00,Not Hispanic or Latino,16,22,1.0,1,,0
2020-12-16 15:00:00,Not Hispanic or Latino,523,545,2.0,3,,0
2020-12-17 15:00:00,Not Hispanic or Latino,1013,1558,,3,,0
2020-12-18 15:00:00,Not Hispanic or Latino,2701,4259,2.0,5,,0
2020-12-19 15:00:00,Not Hispanic or Latino,794,5053,1.0,6,,0
2020-12-20 15:00:00,Not Hispanic or Latino,248,5301,3.0,9,,0
2020-12-21 15:00:00,Not Hispanic or Latino,3520,8821,3.0,12,,0
2020-12-22 15:00:00,Not Hispanic or Latino,5541,14362,4.0,16,,0
2020-12-23 15:00:00,Not Hispanic or Latino,5133,19495,13.0,29,,0
2020-12-24 15:00:00,Not Hispanic or Latino,2501,21996,5.0,34,,0
2020-12-25 15:00:00,Not Hispanic or Latino,811,22807,2.0,36,,0
2020-12-26 15:00:00,Not Hispanic or Latino,1437,24244,3.0,39,,0
2020-12-27 15:00:00,Not Hispanic or Latino,1569,25813,5.0,44,,0
2020-12-28 15:00:00,Not Hispanic or Latino,8101,33914,15.0,59,,0
2020-12-29 15:00:00,Not Hispanic or Latino,9696,43610,9.0,68,,0
2020-12-30 15:00:00,Not Hispanic or Latino,11412,55022,24.0,92,,0
2020-12-31 15:00:00,Not Hispanic or Latino,6863,61885,11.0,103,,0
2021-01-01 15:00:00,Not Hispanic or Latino,1581,63466,39.0,142,,0
2021-01-02 15:00:00,Not Hispanic or Latino,2454,65920,23.0,165,,0
2021-01-03 15:00:00,Not Hispanic or Latino,2850,68770,63.0,228,,0
2021-01-04 15:00:00,Not Hispanic or Latino,11720,80490,249.0,477,,0
2021-01-05 15:00:00,Not Hispanic or Latino,11072,91562,413.0,890,,0
2021-01-06 15:00:00,Not Hispanic or Latino,13530,105092,740.0,1630,,0
2021-01-07 15:00:00,Not Hispanic or Latino,13474,118566,1490.0,3120,,0
2021-01-08 15:00:00,Not Hispanic or Latino,14529,133095,2419.0,5539,,0
2021-01-09 15:00:00,Not Hispanic or Latino,4568,137663,803.0,6342,,0
2021-01-10 15:00:00,Not Hispanic or Latino,2462,140125,313.0,6655,,0
2021-01-11 15:00:00,Not Hispanic or Latino,12603,152728,3069.0,9724,,0
2021-01-12 15:00:00,Not Hispanic or Latino,15597,168325,4820.0,14544,,0
2021-01-13 15:00:00,Not Hispanic or Latino,17168,185493,3460.0,18004,,0
2021-01-14 15:00:00,Not Hispanic or Latino,16358,201851,1717.0,19721,,0
2021-01-15 15:00:00,Not Hispanic or Latino,17621,219472,1590.0,21311,,0
2021-01-16 15:00:00,Not Hispanic or Latino,5062,224534,1331.0,22642,,0
2021-01-17 15:00:00,Not Hispanic or Latino,1912,226446,1185.0,23827,,0
2021-01-18 15:00:00,Not Hispanic or Latino,6801,233247,2590.0,26417,,0
2021-01-19 15:00:00,Not Hispanic or Latino,15956,249203,4582.0,30999,,0
2021-01-20 15:00:00,Not Hispanic or Latino,19744,268947,4681.0,35680,,0
2021-01-21 15:00:00,Not Hispanic or Latino,22012,290959,3245.0,38925,,0
2021-01-22 15:00:00,Not Hispanic or Latino,26790,317749,3026.0,41951,,0
2021-01-23 15:00:00,Not Hispanic or Latino,8907,326656,1405.0,43356,,0
2021-01-24 15:00:00,Not Hispanic or Latino,3003,329659,1385.0,44741,,0
2021-01-25 15:00:00,Not Hispanic or Latino,15360,345019,7352.0,52093,,0
2021-01-26 15:00:00,Not Hispanic or Latino,16322,361341,7975.0,60068,,0
2021-01-27 15:00:00,Not Hispanic or Latino,22932,384273,11175.0,71243,,0
2021-01-28 15:00:00,Not Hispanic or Latino,21182,405455,8347.0,79590,,0
2021-01-29 15:00:00,Not Hispanic or Latino,22861,428316,6699.0,86289,,0
2021-01-30 15:00:00,Not Hispanic or Latino,16727,445043,2191.0,88480,,0
2021-01-31 15:00:00,Not Hispanic or Latino,3209,448252,1118.0,89598,,0
2021-02-01 15:00:00,Not Hispanic or Latino,6137,454389,4009.0,93607,,0
2021-02-02 15:00:00,Not Hispanic or Latino,11120,465509,12166.0,105773,,0
2021-02-03 15:00:00,Not Hispanic or Latino,16546,482055,16629.0,122402,,0
2021-02-04 15:00:00,Not Hispanic or Latino,20223,502278,14199.0,136601,,0
2021-02-05 15:00:00,Not Hispanic or Latino,18538,520816,15709.0,152310,,0
2021-02-06 15:00:00,Not Hispanic or Latino,10309,531125,5799.0,158109,,0
2021-02-07 15:00:00,Not Hispanic or Latino,5302,536427,1521.0,159630,,0
2021-02-08 15:00:00,Not Hispanic or Latino,11502,547929,11744.0,171374,,0
2021-02-09 15:00:00,Not Hispanic or Latino,15052,562981,12626.0,184000,,0
2021-02-10 15:00:00,Not Hispanic or Latino,17519,580500,19730.0,203730,,0
2021-02-11 15:00:00,Not Hispanic or Latino,20968,601468,15840.0,219570,,0
2021-02-12 15:00:00,Not Hispanic or Latino,18630,620098,17764.0,237334,,0
2021-02-13 15:00:00,Not Hispanic or Latino,10507,630605,5623.0,242957,,0
2021-02-14 15:00:00,Not Hispanic or Latino,6303,636908,1792.0,244749,,0
2021-02-15 15:00:00,Not Hispanic or Latino,10849,647757,11991.0,256740,,0
2021-02-16 15:00:00,Not Hispanic or Latino,15241,662998,19431.0,276171,,0
2021-02-17 15:00:00,Not Hispanic or Latino,18986,681984,24724.0,300895,,0
2021-02-18 15:00:00,Not Hispanic or Latino,2738,684722,4038.0,304933,,0
2021-02-19 15:00:00,Not Hispanic or Latino,9544,694266,18039.0,322972,,0
2021-02-20 15:00:00,Not Hispanic or Latino,9291,703557,18825.0,341797,,0
2021-02-21 15:00:00,Not Hispanic or Latino,5419,708976,6875.0,348672,,0
2021-02-22 15:00:00,Not Hispanic or Latino,7263,716239,14206.0,362878,,0
2021-02-23 15:00:00,Not Hispanic or Latino,14165,730404,14737.0,377615,,0
2021-02-24 15:00:00,Not Hispanic or Latino,16653,747057,23017.0,400632,,0
2021-02-25 15:00:00,Not Hispanic or Latino,18815,765872,24524.0,425156,,0
2021-02-26 15:00:00,Not Hispanic or Latino,24667,790539,24058.0,449214,,0
2021-02-27 15:00:00,Not Hispanic or Latino,14588,805127,10267.0,459481,,0
2021-02-28 15:00:00,Not Hispanic or Latino,14053,819180,4230.0,463711,,0
2021-03-01 15:00:00,Not Hispanic or Latino,22513,841693,10662.0,474373,,0
2021-03-02 15:00:00,Not Hispanic or Latino,21631,863324,11970.0,486343,22.0,22
2021-03-03 15:00:00,Not Hispanic or Latino,27373,890697,16704.0,503047,135.0,157
2021-03-04 15:00:00,Not Hispanic or Latino,28244,918941,16629.0,519676,3808.0,3965
2021-03-05 15:00:00,Not Hispanic or Latino,25906,944847,17622.0,537298,4578.0,8543
2021-03-06 15:00:00,Not Hispanic or Latino,16050,960897,8123.0,545421,5384.0,13927
2021-03-07 15:00:00,Not Hispanic or Latino,10840,971737,4186.0,549607,5977.0,19904
2021-03-08 15:00:00,Not Hispanic or Latino,23371,995108,7814.0,557421,7480.0,27384
2021-03-09 15:00:00,Not Hispanic or Latino,23617,1018725,14163.0,571584,7452.0,34836
2021-03-10 15:00:00,Not Hispanic or Latino,27143,1045868,14465.0,586049,6891.0,41727
2021-03-11 15:00:00,Not Hispanic or Latino,31196,1077064,14924.0,600973,3502.0,45229
2021-03-12 15:00:00,Not Hispanic or Latino,33274,1110338,16365.0,617338,2502.0,47731
2021-03-13 15:00:00,Not Hispanic or Latino,20383,1130721,9222.0,626560,1279.0,49010
2021-03-14 15:00:00,Not Hispanic or Latino,15138,1145859,5971.0,632531,791.0,49801
2021-03-15 15:00:00,Not Hispanic or Latino,25987,1171846,10171.0,642702,482.0,50283
2021-03-16 15:00:00,Not Hispanic or Latino,29370,1201216,12134.0,654836,694.0,50977
2021-03-17 15:00:00,Not Hispanic or Latino,33042,1234258,15284.0,670120,1023.0,52000
2021-03-18 15:00:00,Not Hispanic or Latino,36551,1270809,11326.0,681446,1184.0,53184
2021-03-09 15:00:00,Hispanic or Latino,1230,42285,471.0,21483,442.0,1842
2021-03-10 15:00:00,Hispanic or Latino,1378,43663,615.0,22098,530.0,2372
2021-03-11 15:00:00,Hispanic or Latino,1529,45192,661.0,22759,252.0,2624
2021-03-12 15:00:00,Hispanic or Latino,2078,47270,664.0,23423,221.0,2845
2021-03-13 15:00:00,Hispanic or Latino,1210,48480,385.0,23808,213.0,3058
2021-03-14 15:00:00,Hispanic or Latino,1539,50019,217.0,24025,109.0,3167
2021-03-15 15:00:00,Hispanic or Latino,1778,51797,337.0,24362,43.0,3210
2021-03-16 15:00:00,Hispanic or Latino,2049,53846,422.0,24784,21.0,3231
2021-03-17 15:00:00,Hispanic or Latino,2487,56333,598.0,25382,59.0,3290
2021-03-18 15:00:00,Hispanic or Latino,2609,58942,393.0,25775,96.0,3386
2021-03-19 15:00:00,Hispanic or Latino,2614,61556,532.0,26307,81.0,3467
2021-03-20 15:00:00,Hispanic or Latino,2131,63687,419.0,26726,46.0,3513
2021-03-21 15:00:00,Hispanic or Latino,1621,65308,449.0,27175,15.0,3528
2021-03-22 15:00:00,Hispanic or Latino,2247,67555,439.0,27614,32.0,3560
2021-03-23 15:00:00,Hispanic or Latino,2655,70210,614.0,28228,131.0,3691
2021-03-24 15:00:00,Hispanic or Latino,3203,73413,820.0,29048,206.0,3897
2021-03-25 15:00:00,Hispanic or Latino,3353,76766,846.0,29894,114.0,4011
2021-03-26 15:00:00,Hispanic or Latino,2515,79281,1248.0,31142,196.0,4207
2021-03-27 15:00:00,Hispanic or Latino,2229,81510,806.0,31948,139.0,4346
2021-03-28 15:00:00,Hispanic or Latino,1113,82623,546.0,32494,70.0,4416
2021-03-29 15:00:00,Hispanic or Latino,2012,84635,1236.0,33730,61.0,4477
2021-03-30 15:00:00,Hispanic or Latino,2749,87384,1189.0,34919,110.0,4587
2021-03-31 15:00:00,Hispanic or Latino,3415,90799,1339.0,36258,387.0,4974
2021-04-01 15:00:00,Hispanic or Latino,2875,93674,1661.0,37919,296.0,5270
2021-04-02 15:00:00,Hispanic or Latino,2755,96429,1894.0,39813,326.0,5596
2021-04-03 15:00:00,Hispanic or Latino,2107,98536,995.0,40808,284.0,5880
2021-04-04 15:00:00,Hispanic or Latino,686,99222,577.0,41385,50.0,5930
2021-04-05 15:00:00,Hispanic or Latino,2305,101527,1510.0,42895,359.0,6289
2021-04-06 15:00:00,Hispanic or Latino,3121,104648,1789.0,44684,516.0,6805
2021-04-07 15:00:00,Hispanic or Latino,3543,108191,1767.0,46451,867.0,7672
2021-04-08 15:00:00,Hispanic or Latino,3338,111529,1907.0,48358,1205.0,8877
2021-04-09 15:00:00,Hispanic or Latino,3239,114768,2196.0,50554,1103.0,9980
2021-04-10 15:00:00,Hispanic or Latino,2219,116987,1563.0,52117,609.0,10589
2021-04-11 15:00:00,Hispanic or Latino,2172,119159,1328.0,53445,648.0,11237
2021-04-12 15:00:00,Hispanic or Latino,2173,121332,2121.0,55566,777.0,12014
2021-04-13 15:00:00,Hispanic or Latino,3634,124966,2517.0,58083,29.0,12043
2021-04-14 15:00:00,Hispanic or Latino,4422,129388,2587.0,60670,34.0,12077
2021-04-15 15:00:00,Hispanic or Latino,3683,133071,2264.0,62934,24.0,12101
2021-04-16 15:00:00,Hispanic or Latino,3700,136771,2797.0,65731,,12101
2021-04-17 15:00:00,Hispanic or Latino,3663,140434,1840.0,67571,,12101
2021-04-18 15:00:00,Hispanic or Latino,2390,142824,1187.0,68758,,12101
2021-04-19 15:00:00,Hispanic or Latino,3382,146206,1909.0,70667,5.0,12106
2021-04-20 15:00:00,Hispanic or Latino,3565,149771,2464.0,73131,,12106
2021-04-21 15:00:00,Hispanic or Latino,5066,154837,3173.0,76304,1.0,12107
2021-04-22 15:00:00,Hispanic or Latino,3941,158778,3193.0,79497,,12107
2021-04-23 15:00:00,Hispanic or Latino,3729,162507,3049.0,82546,,12107
2021-04-24 15:00:00,Hispanic or Latino,4336,166843,2552.0,85098,8.0,12115
2021-04-25 15:00:00,Hispanic or Latino,2890,169733,817.0,85915,3.0,12118
2021-04-26 15:00:00,Hispanic or Latino,3586,173319,2418.0,88333,16.0,12134
2021-04-27 15:00:00,Hispanic or Latino,3543,176862,2579.0,90912,113.0,12247
2021-04-28 15:00:00,Hispanic or Latino,3677,180539,3628.0,94540,142.0,12389
2021-04-29 15:00:00,Hispanic or Latino,3617,184156,3069.0,97609,158.0,12547
2021-04-30 15:00:00,Hispanic or Latino,4150,188306,2716.0,100325,174.0,12721
2021-05-01 15:00:00,Hispanic or Latino,3415,191721,2246.0,102571,130.0,12851
2021-05-02 15:00:00,Hispanic or Latino,1607,193328,1621.0,104192,127.0,12978
2021-05-03 15:00:00,Hispanic or Latino,1942,195270,2186.0,106378,237.0,13215
2021-05-04 15:00:00,Hispanic or Latino,1887,197157,3129.0,109507,176.0,13391
2021-05-05 15:00:00,Hispanic or Latino,2902,200059,3808.0,113315,220.0,13611
2021-05-06 15:00:00,Hispanic or Latino,2176,202235,3423.0,116738,165.0,13776
2021-05-07 15:00:00,Hispanic or Latino,3007,205242,3507.0,120245,190.0,13966
2021-05-08 15:00:00,Hispanic or Latino,2013,207255,3186.0,123431,173.0,14139
2021-03-19 15:00:00,Not Hispanic or Latino,33562,1304371,14002.0,695448,886.0,54070
2021-03-20 15:00:00,Not Hispanic or Latino,20805,1325176,8917.0,704365,593.0,54663
2021-03-21 15:00:00,Not Hispanic or Latino,16166,1341342,6691.0,711056,275.0,54938
2021-03-22 15:00:00,Not Hispanic or Latino,28520,1369862,10102.0,721158,757.0,55695
2021-03-23 15:00:00,Not Hispanic or Latino,32832,1402694,15636.0,736794,1319.0,57014
2021-03-24 15:00:00,Not Hispanic or Latino,34924,1437618,19221.0,756015,1078.0,58092
2021-03-25 15:00:00,Not Hispanic or Latino,36038,1473656,19003.0,775018,2020.0,60112
2021-03-26 15:00:00,Not Hispanic or Latino,31354,1505010,23459.0,798477,1941.0,62053
2021-03-27 15:00:00,Not Hispanic or Latino,22793,1527803,15177.0,813654,1847.0,63900
2021-03-28 15:00:00,Not Hispanic or Latino,13886,1541689,11378.0,825032,1123.0,65023
2021-03-29 15:00:00,Not Hispanic or Latino,24943,1566632,23561.0,848593,989.0,66012
2021-03-30 15:00:00,Not Hispanic or Latino,34502,1601134,26228.0,874821,1599.0,67611
2021-03-31 15:00:00,Not Hispanic or Latino,34860,1635994,31763.0,906584,4546.0,72157
2021-04-01 15:00:00,Not Hispanic or Latino,36249,1672243,34031.0,940615,4548.0,76705
2021-04-02 15:00:00,Not Hispanic or Latino,30011,1702254,28511.0,969126,4723.0,81428
2021-04-03 15:00:00,Not Hispanic or Latino,17705,1719959,16437.0,985563,3465.0,84893
2021-04-04 15:00:00,Not Hispanic or Latino,6973,1726932,8779.0,994342,846.0,85739
2021-04-05 15:00:00,Not Hispanic or Latino,23566,1750498,25692.0,1020034,5587.0,91326
2021-04-06 15:00:00,Not Hispanic or Latino,34301,1784799,26783.0,1046817,9065.0,100391
2021-04-07 15:00:00,Not Hispanic or Latino,29757,1814556,30395.0,1077212,10703.0,111094
2021-04-08 15:00:00,Not Hispanic or Latino,35571,1850127,32083.0,1109295,11108.0,122202
2021-04-09 15:00:00,Not Hispanic or Latino,27193,1877320,32394.0,1141689,12061.0,134263
2021-04-10 15:00:00,Not Hispanic or Latino,18350,1895670,20106.0,1161795,5978.0,140241
2021-04-11 15:00:00,Not Hispanic or Latino,12867,1908537,10743.0,1172538,8574.0,148815
2021-04-12 15:00:00,Not Hispanic or Latino,19579,1928116,28752.0,1201290,9032.0,157847
2021-04-13 15:00:00,Not Hispanic or Latino,35476,1963592,31467.0,1232757,278.0,158125
2021-04-14 15:00:00,Not Hispanic or Latino,32394,1995986,32426.0,1265183,158.0,158283
2021-04-15 15:00:00,Not Hispanic or Latino,33283,2029269,33049.0,1298232,110.0,158393
2021-04-16 15:00:00,Not Hispanic or Latino,29076,2058345,31968.0,1330200,10.0,158403
2021-04-17 15:00:00,Not Hispanic or Latino,24202,2082547,16956.0,1347156,4.0,158407
2021-04-18 15:00:00,Not Hispanic or Latino,14420,2096967,13068.0,1360224,4.0,158411
2021-04-19 15:00:00,Not Hispanic or Latino,22132,2119099,29680.0,1389904,45.0,158456
2021-04-20 15:00:00,Not Hispanic or Latino,23282,2142381,36243.0,1426147,33.0,158489
2021-04-21 15:00:00,Not Hispanic or Latino,29486,2171867,37321.0,1463468,14.0,158503
2021-04-22 15:00:00,Not Hispanic or Latino,28137,2200004,35110.0,1498578,16.0,158519
2021-04-23 15:00:00,Not Hispanic or Latino,24665,2224669,33162.0,1531740,13.0,158532
2021-04-24 15:00:00,Not Hispanic or Latino,18853,2243522,23394.0,1555134,63.0,158595
2021-04-25 15:00:00,Not Hispanic or Latino,13896,2257418,6644.0,1561778,21.0,158616
2021-04-26 15:00:00,Not Hispanic or Latino,20175,2277593,26313.0,1588091,177.0,158793
2021-04-27 15:00:00,Not Hispanic or Latino,20596,2298189,28325.0,1616416,901.0,159694
2021-04-28 15:00:00,Not Hispanic or Latino,22733,2320922,32206.0,1648622,1119.0,160813
2021-04-29 15:00:00,Not Hispanic or Latino,21235,2342157,31567.0,1680189,1211.0,162024
2021-04-30 15:00:00,Not Hispanic or Latino,21409,2363566,25583.0,1705772,1331.0,163355
2021-05-01 15:00:00,Not Hispanic or Latino,13194,2376760,18069.0,1723841,774.0,164129
2021-05-02 15:00:00,Not Hispanic or Latino,6315,2383075,11155.0,1734996,639.0,164768
2021-05-03 15:00:00,Not Hispanic or Latino,9775,2392850,21943.0,1756939,1575.0,166343
2021-05-04 15:00:00,Not Hispanic or Latino,11231,2404081,32072.0,1789011,1443.0,167786
2021-05-05 15:00:00,Not Hispanic or Latino,14203,2418284,29018.0,1818029,1559.0,169345
2021-05-06 15:00:00,Not Hispanic or Latino,13188,2431472,31393.0,1849422,1433.0,170778
2021-05-07 15:00:00,Not Hispanic or Latino,12705,2444177,27493.0,1876915,1616.0,172394
2021-05-08 15:00:00,Not Hispanic or Latino,7251,2451428,22804.0,1899719,1001.0,173395
2021-05-09 15:00:00,Not Hispanic or Latino,3494,2454922,8561.0,1908280,553.0,173948
2021-05-10 15:00:00,Not Hispanic or Latino,6576,2461498,22809.0,1931089,1126.0,175074
2021-05-11 15:00:00,Not Hispanic or Latino,9305,2470803,23551.0,1954640,1192.0,176266
2021-05-12 15:00:00,Not Hispanic or Latino,10795,2481598,29393.0,1984033,1381.0,177647
2021-05-13 15:00:00,Not Hispanic or Latino,17983,2499581,26881.0,2010914,1084.0,178731
2021-05-14 15:00:00,Not Hispanic or Latino,19135,2518716,22645.0,2033559,1387.0,180118
2021-05-15 15:00:00,Not Hispanic or Latino,16283,2534999,17107.0,2050666,1005.0,181123
2021-05-16 15:00:00,Not Hispanic or Latino,6915,2541914,12840.0,2063506,696.0,181819
2021-05-17 15:00:00,Not Hispanic or Latino,13817,2555731,20446.0,2083952,1467.0,183286
2021-05-18 15:00:00,Not Hispanic or Latino,16840,2572571,23417.0,2107369,1488.0,184774
2021-05-19 15:00:00,Not Hispanic or Latino,22408,2594979,24982.0,2132351,1215.0,185989
2021-05-20 15:00:00,Not Hispanic or Latino,15741,2610720,25180.0,2157531,1551.0,187540
2021-05-21 15:00:00,Not Hispanic or Latino,15234,2625954,23134.0,2180665,1180.0,188720
2021-05-22 15:00:00,Not Hispanic or Latino,11381,2637335,14347.0,2195012,777.0,189497
2021-05-23 15:00:00,Not Hispanic or Latino,6126,2643461,7758.0,2202770,589.0,190086
2021-05-24 15:00:00,Not Hispanic or Latino,9869,2653330,12942.0,2215712,1040.0,191126
2021-05-25 15:00:00,Not Hispanic or Latino,9241,2662571,14243.0,2229955,951.0,192077
2021-05-26 15:00:00,Not Hispanic or Latino,13359,2675930,14248.0,2244203,1046.0,193123
2021-05-27 15:00:00,Not Hispanic or Latino,8820,2684750,14090.0,2258293,824.0,193947
2021-05-28 15:00:00,Not Hispanic or Latino,9171,2693921,14535.0,2272828,1016.0,194963
2021-05-29 15:00:00,Not Hispanic or Latino,6215,2700136,7448.0,2280276,540.0,195503
2021-05-30 15:00:00,Not Hispanic or Latino,3371,2703507,4426.0,2284702,340.0,195843
2021-05-31 15:00:00,Not Hispanic or Latino,1155,2704662,2615.0,2287317,186.0,196029
2021-06-01 15:00:00,Not Hispanic or Latino,7119,2711781,12696.0,2300013,812.0,196841
2021-06-02 15:00:00,Not Hispanic or Latino,7583,2719364,13088.0,2313101,724.0,197565
2021-06-03 15:00:00,Not Hispanic or Latino,6036,2725400,17251.0,2330352,829.0,198394
2021-06-04 15:00:00,Not Hispanic or Latino,6274,2731674,17032.0,2347384,836.0,199230
2021-06-05 15:00:00,Not Hispanic or Latino,4899,2736573,15125.0,2362509,536.0,199766
2021-06-06 15:00:00,Not Hispanic or Latino,2297,2738870,5596.0,2368105,237.0,200003
2021-06-07 15:00:00,Not Hispanic or Latino,5047,2743917,13142.0,2381247,555.0,200558
2021-06-08 15:00:00,Not Hispanic or Latino,5184,2749101,15730.0,2396977,593.0,201151
2021-06-09 15:00:00,Not Hispanic or Latino,5512,2754613,18808.0,2415785,710.0,201861
2021-06-10 15:00:00,Not Hispanic or Latino,4720,2759333,13950.0,2429735,634.0,202495
2021-06-11 15:00:00,Not Hispanic or Latino,4071,2763404,11399.0,2441134,748.0,203243
2021-06-12 15:00:00,Not Hispanic or Latino,3201,2766605,10231.0,2451365,383.0,203626
2021-06-13 15:00:00,Not Hispanic or Latino,842,2767447,4331.0,2455696,206.0,203832
2021-06-14 15:00:00,Not Hispanic or Latino,698,2768145,2541.0,2458237,184.0,204016
2021-05-09 15:00:00,Hispanic or Latino,968,208223,1455.0,124886,103.0,14242
2021-05-10 15:00:00,Hispanic or Latino,1311,209534,3064.0,127950,139.0,14381
2021-05-11 15:00:00,Hispanic or Latino,1807,211341,3022.0,130972,155.0,14536
2021-05-12 15:00:00,Hispanic or Latino,2262,213603,4219.0,135191,337.0,14873
2021-05-13 15:00:00,Hispanic or Latino,2486,216089,3421.0,138612,119.0,14992
2021-05-14 15:00:00,Hispanic or Latino,3314,219403,2919.0,141531,183.0,15175
2021-05-15 15:00:00,Hispanic or Latino,3336,222739,3374.0,144905,233.0,15408
2021-05-16 15:00:00,Hispanic or Latino,1403,224142,2295.0,147200,201.0,15609
2021-05-17 15:00:00,Hispanic or Latino,1945,226087,3092.0,150292,191.0,15800
2021-05-18 15:00:00,Hispanic or Latino,2757,228844,3712.0,154004,230.0,16030
2021-05-19 15:00:00,Hispanic or Latino,4080,232924,3949.0,157953,231.0,16261
2021-05-20 15:00:00,Hispanic or Latino,3004,235928,3810.0,161763,224.0,16485
2021-05-21 15:00:00,Hispanic or Latino,2955,238883,4141.0,165904,222.0,16707
2021-05-22 15:00:00,Hispanic or Latino,3198,242081,3381.0,169285,241.0,16948
2021-05-23 15:00:00,Hispanic or Latino,1734,243815,1951.0,171236,171.0,17119
2021-05-24 15:00:00,Hispanic or Latino,1945,245760,2378.0,173614,177.0,17296
2021-05-25 15:00:00,Hispanic or Latino,2061,247821,2328.0,175942,142.0,17438
2021-05-26 15:00:00,Hispanic or Latino,2682,250503,2738.0,178680,151.0,17589
2021-05-27 15:00:00,Hispanic or Latino,1664,252167,2333.0,181013,115.0,17704
2021-05-28 15:00:00,Hispanic or Latino,2079,254246,3024.0,184037,194.0,17898
2021-05-29 15:00:00,Hispanic or Latino,2376,256622,2191.0,186228,146.0,18044
2021-05-30 15:00:00,Hispanic or Latino,1100,257722,1057.0,187285,103.0,18147
2021-05-31 15:00:00,Hispanic or Latino,291,258013,535.0,187820,43.0,18190
2021-06-01 15:00:00,Hispanic or Latino,1731,259744,2113.0,189933,148.0,18338
2021-06-02 15:00:00,Hispanic or Latino,2013,261757,2074.0,192007,123.0,18461
2021-06-03 15:00:00,Hispanic or Latino,1404,263161,2086.0,194093,121.0,18582
2021-06-04 15:00:00,Hispanic or Latino,1530,264691,3142.0,197235,132.0,18714
2021-06-05 15:00:00,Hispanic or Latino,1553,266244,2418.0,199653,115.0,18829
2021-06-06 15:00:00,Hispanic or Latino,972,267216,836.0,200489,84.0,18913
2021-06-07 15:00:00,Hispanic or Latino,1395,268611,1727.0,202216,99.0,19012
2021-06-08 15:00:00,Hispanic or Latino,1319,269930,2480.0,204696,113.0,19125
2021-06-09 15:00:00,Hispanic or Latino,1880,271810,3430.0,208126,139.0,19264
2021-06-10 15:00:00,Hispanic or Latino,1211,273021,2690.0,210816,97.0,19361
2021-06-11 15:00:00,Hispanic or Latino,1309,274330,2283.0,213099,187.0,19548
2021-06-12 15:00:00,Hispanic or Latino,1232,275562,3024.0,216123,110.0,19658
2021-06-13 15:00:00,Hispanic or Latino,423,275985,1220.0,217343,93.0,19751
2021-06-14 15:00:00,Hispanic or Latino,279,276264,497.0,217840,33.0,19784
