VACCINATION_DATE,Ethnicity,FirstDoseDaily,FirstDoseCumulative,SecondDoseDaily,SecondDoseCumulative,SingleDoseDaily,SingleDoseCumulative
2020-12-14 15:00:00,Unknown,1,1,,0,,0
2020-12-16 15:00:00,Unknown,10,11,,0,,0
2020-12-17 15:00:00,Unknown,20,31,,0,,0
2020-12-18 15:00:00,Unknown,93,124,,0,,0
2020-12-19 15:00:00,Unknown,37,161,,0,,0
2020-12-20 15:00:00,Unknown,29,190,,0,,0
2020-12-21 15:00:00,Unknown,72,262,1.0,1,,0
2020-12-22 15:00:00,Unknown,410,672,,1,,0
2020-12-23 15:00:00,Unknown,200,872,,1,,0
2020-12-24 15:00:00,Unknown,67,939,,1,,0
2020-12-25 15:00:00,Unknown,178,1117,,1,,0
2020-12-26 15:00:00,Unknown,196,1313,,1,,0
2020-12-27 15:00:00,Unknown,141,1454,,1,,0
2020-12-28 15:00:00,Unknown,291,1745,,1,,0
2020-12-29 15:00:00,Unknown,489,2234,,1,,0
2020-12-30 15:00:00,Unknown,378,2612,,1,,0
2020-12-31 15:00:00,Unknown,217,2829,,1,,0
2021-01-01 15:00:00,Unknown,147,2976,2.0,3,,0
2021-01-02 15:00:00,Unknown,174,3150,2.0,5,,0
2021-01-03 15:00:00,Unknown,225,3375,4.0,9,,0
2021-01-04 15:00:00,Unknown,587,3962,6.0,15,,0
2021-01-05 15:00:00,Unknown,516,4478,18.0,33,,0
2021-01-06 15:00:00,Unknown,653,5131,24.0,57,,0
2021-01-07 15:00:00,Unknown,407,5538,57.0,114,,0
2021-01-08 15:00:00,Unknown,8306,13844,76.0,190,,0
2021-01-09 15:00:00,Unknown,224,14068,45.0,235,,0
2021-01-10 15:00:00,Unknown,177,14245,9.0,244,,0
2021-01-11 15:00:00,Unknown,330,14575,85.0,329,,0
2021-01-12 15:00:00,Unknown,701,15276,345.0,674,,0
2021-01-13 15:00:00,Unknown,418,15694,134.0,808,,0
2021-01-14 15:00:00,Unknown,400,16094,62.0,870,,0
2021-01-15 15:00:00,Unknown,556,16650,180.0,1050,,0
2021-01-16 15:00:00,Unknown,292,16942,153.0,1203,,0
2021-01-17 15:00:00,Unknown,111,17053,94.0,1297,,0
2021-01-18 15:00:00,Unknown,163,17216,200.0,1497,,0
2021-01-19 15:00:00,Unknown,334,17550,287.0,1784,,0
2021-01-20 15:00:00,Unknown,420,17970,182.0,1966,,0
2021-01-21 15:00:00,Unknown,509,18479,108.0,2074,,0
2021-01-22 15:00:00,Unknown,730,19209,169.0,2243,,0
2021-01-23 15:00:00,Unknown,460,19669,162.0,2405,,0
2021-01-24 15:00:00,Unknown,201,19870,146.0,2551,,0
2021-01-25 15:00:00,Unknown,601,20471,463.0,3014,,0
2021-01-26 15:00:00,Unknown,682,21153,373.0,3387,,0
2021-01-27 15:00:00,Unknown,617,21770,538.0,3925,,0
2021-01-28 15:00:00,Unknown,594,22364,273.0,4198,,0
2021-01-29 15:00:00,Unknown,658,23022,210.0,4408,,0
2021-01-30 15:00:00,Unknown,481,23503,61.0,4469,,0
2021-01-31 15:00:00,Unknown,437,23940,82.0,4551,,0
2021-02-01 15:00:00,Unknown,479,24419,214.0,4765,,0
2021-02-02 15:00:00,Unknown,665,25084,644.0,5409,,0
2021-02-03 15:00:00,Unknown,803,25887,478.0,5887,,0
2021-02-04 15:00:00,Unknown,892,26779,440.0,6327,,0
2021-02-05 15:00:00,Unknown,725,27504,439.0,6766,,0
2021-02-06 15:00:00,Unknown,585,28089,8207.0,14973,,0
2021-02-07 15:00:00,Unknown,384,28473,89.0,15062,,0
2021-04-13 15:00:00,Federal Entities,84295,84295,54201.0,54201,2952.0,2952
2021-04-14 15:00:00,Federal Entities,557,84852,11.0,54212,1.0,2953
2021-04-15 15:00:00,Federal Entities,623,85475,823.0,55035,19.0,2972
2021-04-16 15:00:00,Federal Entities,782,86257,1016.0,56051,8.0,2980
2021-04-17 15:00:00,Federal Entities,1136,87393,1177.0,57228,6.0,2986
2021-04-19 15:00:00,Federal Entities,1369,88762,2003.0,59231,9.0,2995
2021-04-20 15:00:00,Federal Entities,3243,92005,2158.0,61389,19.0,3014
2021-04-21 15:00:00,Federal Entities,906,92911,1206.0,62595,4.0,3018
2021-04-22 15:00:00,Federal Entities,1018,93929,458.0,63053,,3018
2021-04-23 15:00:00,Federal Entities,759,94688,632.0,63685,1.0,3019
2021-04-25 15:00:00,Federal Entities,992,95680,2492.0,66177,5.0,3024
2021-04-26 15:00:00,Federal Entities,1483,97163,1672.0,67849,1.0,3025
2021-04-29 15:00:00,Federal Entities,223,97386,865.0,68714,2.0,3027
2021-05-01 15:00:00,Federal Entities,1556,98942,1974.0,70688,14.0,3041
2021-05-02 15:00:00,Federal Entities,1071,100013,1875.0,72563,4.0,3045
2021-05-03 15:00:00,Federal Entities,403,100416,2165.0,74728,4.0,3049
2021-05-04 15:00:00,Federal Entities,28,100444,25.0,74753,,3049
2021-05-05 15:00:00,Federal Entities,365,100809,814.0,75567,,3049
2021-05-06 15:00:00,Federal Entities,275,101084,880.0,76447,3.0,3052
2021-05-07 15:00:00,Federal Entities,274,101358,966.0,77413,8.0,3060
2021-05-08 15:00:00,Federal Entities,297,101655,1312.0,78725,6.0,3066
2021-05-10 15:00:00,Federal Entities,338,101993,1712.0,80437,1.0,3067
2021-05-11 15:00:00,Federal Entities,18,102011,13.0,80450,,3067
2021-05-12 15:00:00,Federal Entities,243,102254,1124.0,81574,,3067
2021-05-14 15:00:00,Federal Entities,290,102544,1022.0,82596,2.0,3069
2021-05-15 15:00:00,Federal Entities,611,103155,1701.0,84297,4.0,3073
2021-05-17 15:00:00,Federal Entities,565,103720,2505.0,86802,11.0,3084
2021-05-18 15:00:00,Federal Entities,164,103884,61.0,86863,2.0,3086
2021-05-20 15:00:00,Federal Entities,885,104769,1024.0,87887,,3086
2021-05-22 15:00:00,Federal Entities,911,105680,1359.0,89246,9.0,3095
2021-05-24 15:00:00,Federal Entities,514,106194,1032.0,90278,8.0,3103
2021-05-25 15:00:00,Federal Entities,5,106199,1.0,90279,2.0,3105
2021-05-27 15:00:00,Federal Entities,425,106624,674.0,90953,1.0,3106
2021-05-28 15:00:00,Federal Entities,418,107042,342.0,91295,,3106
2021-05-29 15:00:00,Federal Entities,267,107309,344.0,91639,10.0,3116
2021-05-31 15:00:00,Federal Entities,214,107523,243.0,91882,3.0,3119
2021-06-01 15:00:00,Federal Entities,30,107553,48.0,91930,,3119
2021-06-16 15:00:00,Federal Entities,2042,109595,3555.0,95485,37.0,3156
2021-06-17 15:00:00,Federal Entities,22,109617,95.0,95580,,3156
2021-06-18 15:00:00,Federal Entities,269,109886,456.0,96036,4.0,3160
2021-06-19 15:00:00,Federal Entities,166,110052,338.0,96374,1.0,3161
2021-06-20 15:00:00,Federal Entities,161,110213,284.0,96658,1.0,3162
2021-06-21 15:00:00,Federal Entities,56,110269,120.0,96778,1.0,3163
2021-06-22 15:00:00,Federal Entities,13,110282,8.0,96786,1.0,3164
2021-06-23 15:00:00,Federal Entities,2,110284,2.0,96788,,3164
2021-06-24 15:00:00,Federal Entities,304,110588,355.0,97143,5.0,3169
2021-06-25 15:00:00,Federal Entities,124,110712,209.0,97352,1.0,3170
2021-06-27 15:00:00,Federal Entities,124,110836,173.0,97525,2.0,3172
2021-06-28 15:00:00,Federal Entities,146,110982,186.0,97711,4.0,3176
2021-06-29 15:00:00,Federal Entities,2,110984,2.0,97713,1.0,3177
2021-07-01 15:00:00,Federal Entities,313,111297,340.0,98053,8.0,3185
2021-07-02 15:00:00,Federal Entities,209,111506,249.0,98302,6.0,3191
2021-07-03 15:00:00,Federal Entities,97,111603,123.0,98425,4.0,3195
2021-07-04 15:00:00,Federal Entities,75,111678,98.0,98523,6.0,3201
2021-07-05 15:00:00,Federal Entities,7,111685,8.0,98531,,3201
2021-02-08 15:00:00,Unknown,773,29246,318.0,15380,,0
2021-02-09 15:00:00,Unknown,765,30011,347.0,15727,,0
2021-02-10 15:00:00,Unknown,793,30804,459.0,16186,,0
2021-02-11 15:00:00,Unknown,850,31654,449.0,16635,,0
2021-02-12 15:00:00,Unknown,735,32389,592.0,17227,,0
2021-02-13 15:00:00,Unknown,401,32790,179.0,17406,,0
2021-02-14 15:00:00,Unknown,428,33218,121.0,17527,,0
2021-02-15 15:00:00,Unknown,442,33660,534.0,18061,,0
2021-02-16 15:00:00,Unknown,701,34361,811.0,18872,,0
2021-02-17 15:00:00,Unknown,785,35146,613.0,19485,,0
2021-02-18 15:00:00,Unknown,254,35400,269.0,19754,,0
2021-02-19 15:00:00,Unknown,503,35903,544.0,20298,,0
2021-02-20 15:00:00,Unknown,571,36474,586.0,20884,,0
2021-02-21 15:00:00,Unknown,338,36812,397.0,21281,,0
2021-02-22 15:00:00,Unknown,436,37248,525.0,21806,,0
2021-02-23 15:00:00,Unknown,663,37911,514.0,22320,,0
2021-02-24 15:00:00,Unknown,615,38526,601.0,22921,,0
2021-02-25 15:00:00,Unknown,611,39137,841.0,23762,,0
2021-02-26 15:00:00,Unknown,757,39894,846.0,24608,,0
2021-02-27 15:00:00,Unknown,563,40457,442.0,25050,,0
2021-02-28 15:00:00,Unknown,607,41064,229.0,25279,,0
2021-03-01 15:00:00,Unknown,862,41926,551.0,25830,,0
2021-03-02 15:00:00,Unknown,783,42709,559.0,26389,1.0,1
2021-03-03 15:00:00,Unknown,988,43697,599.0,26988,3.0,4
2021-03-04 15:00:00,Unknown,958,44655,672.0,27660,100.0,104
2021-03-05 15:00:00,Unknown,1013,45668,571.0,28231,87.0,191
2021-03-06 15:00:00,Unknown,635,46303,301.0,28532,188.0,379
2021-03-07 15:00:00,Unknown,513,46816,328.0,28860,284.0,663
2021-03-08 15:00:00,Unknown,966,47782,344.0,29204,354.0,1017
2021-03-09 15:00:00,Unknown,933,48715,451.0,29655,363.0,1380
2021-03-10 15:00:00,Unknown,873,49588,480.0,30135,483.0,1863
2021-03-11 15:00:00,Unknown,1302,50890,503.0,30638,203.0,2066
2021-03-12 15:00:00,Unknown,1245,52135,597.0,31235,162.0,2228
2021-03-13 15:00:00,Unknown,831,52966,358.0,31593,74.0,2302
2021-03-14 15:00:00,Unknown,1005,53971,340.0,31933,66.0,2368
2021-03-15 15:00:00,Unknown,1664,55635,414.0,32347,37.0,2405
2021-03-16 15:00:00,Unknown,1624,57259,602.0,32949,41.0,2446
2021-03-17 15:00:00,Unknown,1645,58904,679.0,33628,66.0,2512
2021-03-18 15:00:00,Unknown,1773,60677,482.0,34110,60.0,2572
2021-03-19 15:00:00,Unknown,1466,62143,482.0,34592,59.0,2631
2021-03-20 15:00:00,Unknown,1247,63390,433.0,35025,155.0,2786
2021-03-21 15:00:00,Unknown,1059,64449,475.0,35500,24.0,2810
2021-03-22 15:00:00,Unknown,1550,65999,533.0,36033,33.0,2843
2021-03-23 15:00:00,Unknown,1930,67929,643.0,36676,71.0,2914
2021-03-24 15:00:00,Unknown,2570,70499,547.0,37223,72.0,2986
2021-03-25 15:00:00,Unknown,2604,73103,612.0,37835,324.0,3310
2021-03-26 15:00:00,Unknown,2561,75664,725.0,38560,348.0,3658
2021-03-27 15:00:00,Unknown,2079,77743,516.0,39076,496.0,4154
2021-03-28 15:00:00,Unknown,1852,79595,491.0,39567,411.0,4565
2021-03-29 15:00:00,Unknown,2592,82187,995.0,40562,76.0,4641
2021-03-30 15:00:00,Unknown,2451,84638,1028.0,41590,125.0,4766
2021-03-31 15:00:00,Unknown,2460,87098,927.0,42517,777.0,5543
2021-04-01 15:00:00,Unknown,1578,88676,1300.0,43817,619.0,6162
2021-07-06 15:00:00,Federal Entities,18,111703,22.0,98553,4.0,3205
2021-07-08 15:00:00,Federal Entities,105,111808,155.0,98708,5.0,3210
2021-07-09 15:00:00,Federal Entities,136,111944,203.0,98911,9.0,3219
2021-07-10 15:00:00,Federal Entities,130,112074,140.0,99051,4.0,3223
2021-07-11 15:00:00,Federal Entities,145,112219,137.0,99188,4.0,3227
2021-07-13 15:00:00,Federal Entities,3,112222,1.0,99189,,3227
2021-07-14 15:00:00,Federal Entities,57,112279,57.0,99246,3.0,3230
2021-07-15 15:00:00,Federal Entities,56,112335,90.0,99336,4.0,3234
2021-07-16 15:00:00,Federal Entities,1012,113347,526.0,99862,24.0,3258
2021-07-17 15:00:00,Federal Entities,86,113433,116.0,99978,4.0,3262
2021-07-18 15:00:00,Federal Entities,152,113585,219.0,100197,10.0,3272
2020-12-15 15:00:00,Hispanic or Latino,4,4,,0,,0
2020-12-16 15:00:00,Hispanic or Latino,19,23,,0,,0
2020-12-17 15:00:00,Hispanic or Latino,38,61,,0,,0
2020-12-18 15:00:00,Hispanic or Latino,85,146,,0,,0
2020-12-19 15:00:00,Hispanic or Latino,37,183,,0,,0
2020-12-20 15:00:00,Hispanic or Latino,10,193,,0,,0
2020-12-21 15:00:00,Hispanic or Latino,146,339,1.0,1,,0
2020-12-22 15:00:00,Hispanic or Latino,257,596,,1,,0
2020-12-23 15:00:00,Hispanic or Latino,189,785,1.0,2,,0
2020-12-24 15:00:00,Hispanic or Latino,92,877,,2,,0
2020-12-25 15:00:00,Hispanic or Latino,39,916,,2,,0
2020-12-26 15:00:00,Hispanic or Latino,46,962,,2,,0
2020-12-27 15:00:00,Hispanic or Latino,60,1022,,2,,0
2020-12-28 15:00:00,Hispanic or Latino,264,1286,1.0,3,,0
2020-12-29 15:00:00,Hispanic or Latino,368,1654,2.0,5,,0
2020-12-30 15:00:00,Hispanic or Latino,506,2160,2.0,7,,0
2020-12-31 15:00:00,Hispanic or Latino,329,2489,2.0,9,,0
2021-01-01 15:00:00,Hispanic or Latino,71,2560,6.0,15,,0
2021-01-02 15:00:00,Hispanic or Latino,92,2652,3.0,18,,0
2021-01-03 15:00:00,Hispanic or Latino,124,2776,3.0,21,,0
2021-01-04 15:00:00,Hispanic or Latino,622,3398,12.0,33,,0
2021-01-05 15:00:00,Hispanic or Latino,418,3816,19.0,52,,0
2021-01-06 15:00:00,Hispanic or Latino,603,4419,21.0,73,,0
2021-01-07 15:00:00,Hispanic or Latino,807,5226,61.0,134,,0
2021-01-08 15:00:00,Hispanic or Latino,873,6099,92.0,226,,0
2021-01-09 15:00:00,Hispanic or Latino,195,6294,34.0,260,,0
2021-01-10 15:00:00,Hispanic or Latino,138,6432,22.0,282,,0
2021-01-11 15:00:00,Hispanic or Latino,552,6984,130.0,412,,0
2021-01-12 15:00:00,Hispanic or Latino,739,7723,209.0,621,,0
2021-01-13 15:00:00,Hispanic or Latino,678,8401,132.0,753,,0
2021-01-14 15:00:00,Hispanic or Latino,748,9149,70.0,823,,0
2021-01-15 15:00:00,Hispanic or Latino,880,10029,69.0,892,,0
2021-01-16 15:00:00,Hispanic or Latino,186,10215,42.0,934,,0
2021-01-17 15:00:00,Hispanic or Latino,98,10313,46.0,980,,0
2021-01-18 15:00:00,Hispanic or Latino,166,10479,118.0,1098,,0
2021-01-19 15:00:00,Hispanic or Latino,481,10960,161.0,1259,,0
2021-01-20 15:00:00,Hispanic or Latino,626,11586,189.0,1448,,0
2021-01-21 15:00:00,Hispanic or Latino,760,12346,123.0,1571,,0
2021-01-22 15:00:00,Hispanic or Latino,973,13319,108.0,1679,,0
2021-01-23 15:00:00,Hispanic or Latino,321,13640,69.0,1748,,0
2021-01-24 15:00:00,Hispanic or Latino,90,13730,45.0,1793,,0
2021-01-25 15:00:00,Hispanic or Latino,371,14101,314.0,2107,,0
2021-01-26 15:00:00,Hispanic or Latino,480,14581,239.0,2346,,0
2021-01-27 15:00:00,Hispanic or Latino,752,15333,439.0,2785,,0
2021-01-28 15:00:00,Hispanic or Latino,804,16137,399.0,3184,,0
2021-01-29 15:00:00,Hispanic or Latino,734,16871,304.0,3488,,0
2021-01-30 15:00:00,Hispanic or Latino,509,17380,93.0,3581,,0
2021-01-31 15:00:00,Hispanic or Latino,139,17519,30.0,3611,,0
2021-02-01 15:00:00,Hispanic or Latino,178,17697,164.0,3775,,0
2021-02-02 15:00:00,Hispanic or Latino,418,18115,602.0,4377,,0
2021-02-03 15:00:00,Hispanic or Latino,619,18734,668.0,5045,,0
2021-04-02 15:00:00,Unknown,1836,90512,1353.0,45170,741.0,6903
2021-04-03 15:00:00,Unknown,1625,92137,828.0,45998,649.0,7552
2021-04-04 15:00:00,Unknown,595,92732,645.0,46643,45.0,7597
2021-04-05 15:00:00,Unknown,1860,94592,1165.0,47808,657.0,8254
2021-04-06 15:00:00,Unknown,2197,96789,1274.0,49082,855.0,9109
2021-04-07 15:00:00,Unknown,2441,99230,1364.0,50446,1302.0,10411
2021-04-08 15:00:00,Unknown,3057,102287,1504.0,51950,1475.0,11886
2021-04-09 15:00:00,Unknown,3322,105609,1081.0,53031,1251.0,13137
2021-04-10 15:00:00,Unknown,2925,108534,1031.0,54062,960.0,14097
2021-04-11 15:00:00,Unknown,2455,110989,1048.0,55110,1025.0,15122
2021-04-12 15:00:00,Unknown,2757,113746,1836.0,56946,1062.0,16184
2021-04-13 15:00:00,Unknown,3274,117020,1909.0,58855,34.0,16218
2021-04-14 15:00:00,Unknown,3129,120149,2161.0,61016,10.0,16228
2021-04-15 15:00:00,Unknown,3781,123930,2336.0,63352,14.0,16242
2021-04-16 15:00:00,Unknown,3382,127312,2364.0,65716,2.0,16244
2021-04-17 15:00:00,Unknown,3676,130988,1598.0,67314,1.0,16245
2021-04-18 15:00:00,Unknown,2881,133869,1645.0,68959,,16245
2021-04-19 15:00:00,Unknown,2752,136621,2403.0,71362,2.0,16247
2021-04-20 15:00:00,Unknown,2242,138863,2137.0,73499,,16247
2021-04-21 15:00:00,Unknown,3041,141904,2511.0,76010,1.0,16248
2021-04-22 15:00:00,Unknown,2700,144604,1304.0,77314,,16248
2021-04-23 15:00:00,Unknown,3166,147770,1977.0,79291,2.0,16250
2021-04-24 15:00:00,Unknown,3057,150827,1778.0,81069,3.0,16253
2021-04-25 15:00:00,Unknown,2343,153170,755.0,81824,,16253
2021-04-26 15:00:00,Unknown,1772,154942,1582.0,83406,11.0,16264
2021-04-27 15:00:00,Unknown,2292,157234,1492.0,84898,80.0,16344
2021-04-28 15:00:00,Unknown,2083,159317,2563.0,87461,94.0,16438
2021-04-29 15:00:00,Unknown,1829,161146,2725.0,90186,83.0,16521
2021-04-30 15:00:00,Unknown,1983,163129,2787.0,92973,112.0,16633
2021-05-01 15:00:00,Unknown,1567,164696,2746.0,95719,57.0,16690
2021-05-02 15:00:00,Unknown,1186,165882,2217.0,97936,34.0,16724
2021-05-03 15:00:00,Unknown,778,166660,2773.0,100709,87.0,16811
2021-05-04 15:00:00,Unknown,766,167426,3043.0,103752,102.0,16913
2021-05-05 15:00:00,Unknown,1393,168819,2971.0,106723,114.0,17027
2021-05-06 15:00:00,Unknown,1194,170013,3298.0,110021,96.0,17123
2021-05-07 15:00:00,Unknown,1259,171272,2923.0,112944,113.0,17236
2021-05-08 15:00:00,Unknown,1013,172285,3151.0,116095,107.0,17343
2021-05-09 15:00:00,Unknown,683,172968,1520.0,117615,36.0,17379
2021-05-10 15:00:00,Unknown,625,173593,2886.0,120501,81.0,17460
2021-05-11 15:00:00,Unknown,748,174341,2346.0,122847,85.0,17545
2021-05-12 15:00:00,Unknown,883,175224,2747.0,125594,164.0,17709
2021-05-13 15:00:00,Unknown,1075,176299,2320.0,127914,141.0,17850
2021-05-14 15:00:00,Unknown,1195,177494,2398.0,130312,187.0,18037
2021-05-15 15:00:00,Unknown,1421,178915,2446.0,132758,248.0,18285
2021-05-16 15:00:00,Unknown,565,179480,2105.0,134863,198.0,18483
2021-05-17 15:00:00,Unknown,604,180084,1753.0,136616,225.0,18708
2021-05-18 15:00:00,Unknown,1059,181143,2569.0,139185,190.0,18898
2021-05-19 15:00:00,Unknown,1232,182375,2511.0,141696,166.0,19064
2021-05-20 15:00:00,Unknown,1014,183389,2141.0,143837,176.0,19240
2021-05-21 15:00:00,Unknown,1117,184506,2077.0,145914,197.0,19437
2021-05-22 15:00:00,Unknown,1155,185661,1214.0,147128,233.0,19670
2021-05-23 15:00:00,Unknown,653,186314,1281.0,148409,192.0,19862
2021-05-24 15:00:00,Unknown,610,186924,847.0,149256,225.0,20087
2021-02-04 15:00:00,Hispanic or Latino,748,19482,720.0,5765,,0
2021-02-05 15:00:00,Hispanic or Latino,776,20258,871.0,6636,,0
2021-02-06 15:00:00,Hispanic or Latino,399,20657,207.0,6843,,0
2021-02-07 15:00:00,Hispanic or Latino,166,20823,65.0,6908,,0
2021-02-08 15:00:00,Hispanic or Latino,548,21371,618.0,7526,,0
2021-02-09 15:00:00,Hispanic or Latino,550,21921,528.0,8054,,0
2021-02-10 15:00:00,Hispanic or Latino,698,22619,693.0,8747,,0
2021-02-11 15:00:00,Hispanic or Latino,865,23484,732.0,9479,,0
2021-02-12 15:00:00,Hispanic or Latino,779,24263,857.0,10336,,0
2021-02-13 15:00:00,Hispanic or Latino,371,24634,224.0,10560,,0
2021-02-14 15:00:00,Hispanic or Latino,277,24911,66.0,10626,,0
2021-02-15 15:00:00,Hispanic or Latino,323,25234,362.0,10988,,0
2021-02-16 15:00:00,Hispanic or Latino,517,25751,537.0,11525,,0
2021-02-17 15:00:00,Hispanic or Latino,694,26445,753.0,12278,,0
2021-02-18 15:00:00,Hispanic or Latino,116,26561,134.0,12412,,0
2021-02-19 15:00:00,Hispanic or Latino,366,26927,774.0,13186,,0
2021-02-20 15:00:00,Hispanic or Latino,365,27292,639.0,13825,,0
2021-02-21 15:00:00,Hispanic or Latino,312,27604,250.0,14075,,0
2021-02-22 15:00:00,Hispanic or Latino,287,27891,420.0,14495,,0
2021-02-23 15:00:00,Hispanic or Latino,532,28423,495.0,14990,,0
2021-02-24 15:00:00,Hispanic or Latino,571,28994,825.0,15815,,0
2021-02-25 15:00:00,Hispanic or Latino,781,29775,831.0,16646,,0
2021-02-26 15:00:00,Hispanic or Latino,1135,30910,853.0,17499,,0
2021-02-27 15:00:00,Hispanic or Latino,671,31581,349.0,17848,,0
2021-02-28 15:00:00,Hispanic or Latino,739,32320,182.0,18030,,0
2021-03-01 15:00:00,Hispanic or Latino,1157,33477,430.0,18460,,0
2021-03-02 15:00:00,Hispanic or Latino,1054,34531,356.0,18816,1.0,1
2021-03-03 15:00:00,Hispanic or Latino,1179,35710,665.0,19481,13.0,14
2021-03-04 15:00:00,Hispanic or Latino,1354,37064,507.0,19988,148.0,162
2021-03-05 15:00:00,Hispanic or Latino,1681,38745,611.0,20599,202.0,364
2021-03-06 15:00:00,Hispanic or Latino,897,39642,272.0,20871,379.0,743
2021-03-07 15:00:00,Hispanic or Latino,582,40224,197.0,21068,290.0,1033
2021-03-08 15:00:00,Hispanic or Latino,1226,41450,311.0,21379,364.0,1397
2021-03-09 15:00:00,Hispanic or Latino,1239,42689,468.0,21847,444.0,1841
2021-03-10 15:00:00,Hispanic or Latino,1402,44091,617.0,22464,532.0,2373
2021-03-11 15:00:00,Hispanic or Latino,1682,45773,671.0,23135,255.0,2628
2021-03-12 15:00:00,Hispanic or Latino,2095,47868,674.0,23809,226.0,2854
2021-03-13 15:00:00,Hispanic or Latino,1212,49080,391.0,24200,212.0,3066
2021-03-14 15:00:00,Hispanic or Latino,1544,50624,218.0,24418,109.0,3175
2021-03-15 15:00:00,Hispanic or Latino,1791,52415,349.0,24767,44.0,3219
2021-03-16 15:00:00,Hispanic or Latino,2072,54487,435.0,25202,20.0,3239
2021-03-17 15:00:00,Hispanic or Latino,2498,56985,600.0,25802,59.0,3298
2021-03-18 15:00:00,Hispanic or Latino,2624,59609,404.0,26206,96.0,3394
2021-03-19 15:00:00,Hispanic or Latino,2633,62242,548.0,26754,82.0,3476
2021-03-20 15:00:00,Hispanic or Latino,2144,64386,426.0,27180,50.0,3526
2021-03-21 15:00:00,Hispanic or Latino,1625,66011,455.0,27635,15.0,3541
2021-03-22 15:00:00,Hispanic or Latino,2252,68263,445.0,28080,32.0,3573
2021-03-23 15:00:00,Hispanic or Latino,2664,70927,625.0,28705,131.0,3704
2021-03-24 15:00:00,Hispanic or Latino,3209,74136,832.0,29537,207.0,3911
2021-03-25 15:00:00,Hispanic or Latino,3360,77496,856.0,30393,113.0,4024
2021-03-26 15:00:00,Hispanic or Latino,2532,80028,1267.0,31660,199.0,4223
2021-03-27 15:00:00,Hispanic or Latino,2240,82268,813.0,32473,153.0,4376
2021-03-28 15:00:00,Hispanic or Latino,1122,83390,549.0,33022,72.0,4448
2021-03-29 15:00:00,Hispanic or Latino,2019,85409,1268.0,34290,60.0,4508
2021-03-30 15:00:00,Hispanic or Latino,2765,88174,1202.0,35492,109.0,4617
2021-03-31 15:00:00,Hispanic or Latino,3441,91615,1364.0,36856,387.0,5004
2021-04-01 15:00:00,Hispanic or Latino,2788,94403,1801.0,38657,301.0,5305
2021-04-02 15:00:00,Hispanic or Latino,2757,97160,1913.0,40570,341.0,5646
2021-04-03 15:00:00,Hispanic or Latino,2116,99276,1001.0,41571,285.0,5931
2021-04-04 15:00:00,Hispanic or Latino,692,99968,572.0,42143,49.0,5980
2021-04-05 15:00:00,Hispanic or Latino,2322,102290,1527.0,43670,361.0,6341
2021-04-06 15:00:00,Hispanic or Latino,3122,105412,1804.0,45474,514.0,6855
2021-05-25 15:00:00,Unknown,779,187703,869.0,150125,140.0,20227
2021-05-26 15:00:00,Unknown,907,188610,1122.0,151247,183.0,20410
2021-05-27 15:00:00,Unknown,634,189244,995.0,152242,138.0,20548
2021-05-28 15:00:00,Unknown,666,189910,1251.0,153493,184.0,20732
2021-05-29 15:00:00,Unknown,732,190642,1234.0,154727,229.0,20961
2021-05-30 15:00:00,Unknown,368,191010,860.0,155587,140.0,21101
2021-05-31 15:00:00,Unknown,66,191076,203.0,155790,73.0,21174
2021-06-01 15:00:00,Unknown,537,191613,927.0,156717,136.0,21310
2021-06-02 15:00:00,Unknown,528,192141,1011.0,157728,84.0,21394
2021-06-03 15:00:00,Unknown,423,192564,1019.0,158747,104.0,21498
2021-06-04 15:00:00,Unknown,444,193008,1123.0,159870,65.0,21563
2021-06-05 15:00:00,Unknown,490,193498,1173.0,161043,48.0,21611
2021-06-06 15:00:00,Unknown,208,193706,481.0,161524,67.0,21678
2021-06-07 15:00:00,Unknown,355,194061,430.0,161954,54.0,21732
2021-06-08 15:00:00,Unknown,370,194431,779.0,162733,82.0,21814
2021-06-09 15:00:00,Unknown,471,194902,939.0,163672,64.0,21878
2021-06-10 15:00:00,Unknown,460,195362,897.0,164569,71.0,21949
2021-06-11 15:00:00,Unknown,513,195875,895.0,165464,108.0,22057
2021-06-12 15:00:00,Unknown,483,196358,1051.0,166515,87.0,22144
2021-06-13 15:00:00,Unknown,230,196588,487.0,167002,55.0,22199
2021-06-14 15:00:00,Unknown,305,196893,398.0,167400,60.0,22259
2021-06-15 15:00:00,Unknown,377,197270,791.0,168191,107.0,22366
2021-06-16 15:00:00,Unknown,320,197590,711.0,168902,72.0,22438
2021-06-17 15:00:00,Unknown,347,197937,543.0,169445,89.0,22527
2021-06-18 15:00:00,Unknown,353,198290,588.0,170033,58.0,22585
2021-06-19 15:00:00,Unknown,272,198562,629.0,170662,50.0,22635
2021-06-20 15:00:00,Unknown,170,198732,250.0,170912,33.0,22668
2021-06-21 15:00:00,Unknown,316,199048,178.0,171090,31.0,22699
2021-06-22 15:00:00,Unknown,374,199422,500.0,171590,93.0,22792
2021-06-23 15:00:00,Unknown,357,199779,453.0,172043,45.0,22837
2021-06-24 15:00:00,Unknown,342,200121,322.0,172365,44.0,22881
2021-06-25 15:00:00,Unknown,346,200467,347.0,172712,52.0,22933
2021-06-26 15:00:00,Unknown,283,200750,380.0,173092,60.0,22993
2021-06-27 15:00:00,Unknown,245,200995,164.0,173256,15.0,23008
2021-06-28 15:00:00,Unknown,458,201453,219.0,173475,33.0,23041
2021-06-29 15:00:00,Unknown,460,201913,318.0,173793,54.0,23095
2021-06-30 15:00:00,Unknown,417,202330,292.0,174085,40.0,23135
2021-07-01 15:00:00,Unknown,380,202710,348.0,174433,51.0,23186
2021-07-02 15:00:00,Unknown,369,203079,343.0,174776,34.0,23220
2021-07-03 15:00:00,Unknown,313,203392,274.0,175050,23.0,23243
2021-07-04 15:00:00,Unknown,31,203423,14.0,175064,1.0,23244
2021-07-05 15:00:00,Unknown,352,203775,203.0,175267,15.0,23259
2021-07-06 15:00:00,Unknown,344,204119,291.0,175558,59.0,23318
2021-07-07 15:00:00,Unknown,347,204466,232.0,175790,28.0,23346
2021-07-08 15:00:00,Unknown,387,204853,211.0,176001,31.0,23377
2021-07-09 15:00:00,Unknown,337,205190,252.0,176253,63.0,23440
2021-07-10 15:00:00,Unknown,317,205507,215.0,176468,34.0,23474
2021-07-11 15:00:00,Unknown,212,205719,179.0,176647,16.0,23490
2021-07-12 15:00:00,Unknown,301,206020,204.0,176851,21.0,23511
2021-07-13 15:00:00,Unknown,367,206387,215.0,177066,19.0,23530
2021-07-14 15:00:00,Unknown,321,206708,197.0,177263,14.0,23544
2021-07-15 15:00:00,Unknown,324,207032,199.0,177462,9.0,23553
2021-07-16 15:00:00,Unknown,446,207478,191.0,177653,10.0,23563
2021-04-07 15:00:00,Hispanic or Latino,3545,108957,1775.0,47249,873.0,7728
2021-04-08 15:00:00,Hispanic or Latino,3351,112308,1925.0,49174,1204.0,8932
2021-04-09 15:00:00,Hispanic or Latino,3270,115578,2218.0,51392,1109.0,10041
2021-04-10 15:00:00,Hispanic or Latino,2241,117819,1569.0,52961,614.0,10655
2021-04-11 15:00:00,Hispanic or Latino,2166,119985,1334.0,54295,666.0,11321
2021-04-12 15:00:00,Hispanic or Latino,2202,122187,2134.0,56429,781.0,12102
2021-04-13 15:00:00,Hispanic or Latino,3645,125832,2528.0,58957,29.0,12131
2021-04-14 15:00:00,Hispanic or Latino,4458,130290,2593.0,61550,35.0,12166
2021-04-15 15:00:00,Hispanic or Latino,3705,133995,2271.0,63821,24.0,12190
2021-04-16 15:00:00,Hispanic or Latino,3734,137729,2811.0,66632,,12190
2021-04-17 15:00:00,Hispanic or Latino,3688,141417,1850.0,68482,,12190
2021-04-18 15:00:00,Hispanic or Latino,2417,143834,1201.0,69683,,12190
2021-04-19 15:00:00,Hispanic or Latino,3406,147240,1926.0,71609,6.0,12196
2021-04-20 15:00:00,Hispanic or Latino,3641,150881,2510.0,74119,,12196
2021-04-21 15:00:00,Hispanic or Latino,5181,156062,3303.0,77422,1.0,12197
2021-04-22 15:00:00,Hispanic or Latino,4020,160082,3252.0,80674,,12197
2021-04-23 15:00:00,Hispanic or Latino,3783,163865,3072.0,83746,,12197
2021-04-24 15:00:00,Hispanic or Latino,4354,168219,2582.0,86328,8.0,12205
2021-04-25 15:00:00,Hispanic or Latino,2902,171121,823.0,87151,3.0,12208
2021-04-26 15:00:00,Hispanic or Latino,3624,174745,2437.0,89588,16.0,12224
2021-04-27 15:00:00,Hispanic or Latino,3582,178327,2592.0,92180,112.0,12336
2021-04-28 15:00:00,Hispanic or Latino,3736,182063,3686.0,95866,142.0,12478
2021-04-29 15:00:00,Hispanic or Latino,3667,185730,3126.0,98992,159.0,12637
2021-04-30 15:00:00,Hispanic or Latino,4202,189932,2753.0,101745,179.0,12816
2021-05-01 15:00:00,Hispanic or Latino,3460,193392,2303.0,104048,134.0,12950
2021-05-02 15:00:00,Hispanic or Latino,1627,195019,1624.0,105672,129.0,13079
2021-05-03 15:00:00,Hispanic or Latino,1950,196969,2214.0,107886,235.0,13314
2021-05-04 15:00:00,Hispanic or Latino,1941,198910,3198.0,111084,176.0,13490
2021-05-05 15:00:00,Hispanic or Latino,2945,201855,3870.0,114954,222.0,13712
2021-05-06 15:00:00,Hispanic or Latino,2212,204067,3459.0,118413,165.0,13877
2021-05-07 15:00:00,Hispanic or Latino,3034,207101,3667.0,122080,194.0,14071
2021-05-08 15:00:00,Hispanic or Latino,2044,209145,3228.0,125308,174.0,14245
2021-05-09 15:00:00,Hispanic or Latino,961,210106,1481.0,126789,103.0,14348
2021-05-10 15:00:00,Hispanic or Latino,1317,211423,3106.0,129895,140.0,14488
2021-05-11 15:00:00,Hispanic or Latino,1834,213257,3122.0,133017,154.0,14642
2021-05-12 15:00:00,Hispanic or Latino,2254,215511,4315.0,137332,339.0,14981
2021-05-13 15:00:00,Hispanic or Latino,2536,218047,3485.0,140817,119.0,15100
2021-05-14 15:00:00,Hispanic or Latino,3367,221414,2968.0,143785,186.0,15286
2021-05-15 15:00:00,Hispanic or Latino,3395,224809,3401.0,147186,234.0,15520
2021-05-16 15:00:00,Hispanic or Latino,1405,226214,2317.0,149503,200.0,15720
2021-05-17 15:00:00,Hispanic or Latino,1949,228163,3137.0,152640,198.0,15918
2021-05-18 15:00:00,Hispanic or Latino,2875,231038,3775.0,156415,234.0,16152
2021-05-19 15:00:00,Hispanic or Latino,4089,235127,4011.0,160426,235.0,16387
2021-05-20 15:00:00,Hispanic or Latino,3073,238200,3912.0,164338,225.0,16612
2021-05-21 15:00:00,Hispanic or Latino,2963,241163,4201.0,168539,222.0,16834
2021-05-22 15:00:00,Hispanic or Latino,3259,244422,3412.0,171951,245.0,17079
2021-05-23 15:00:00,Hispanic or Latino,1793,246215,2004.0,173955,169.0,17248
2021-05-24 15:00:00,Hispanic or Latino,2016,248231,2428.0,176383,179.0,17427
2021-05-25 15:00:00,Hispanic or Latino,2161,250392,2471.0,178854,159.0,17586
2021-05-26 15:00:00,Hispanic or Latino,2790,253182,2900.0,181754,160.0,17746
2021-05-27 15:00:00,Hispanic or Latino,1715,254897,2369.0,184123,122.0,17868
2021-05-28 15:00:00,Hispanic or Latino,2174,257071,3112.0,187235,195.0,18063
2021-05-29 15:00:00,Hispanic or Latino,2410,259481,2242.0,189477,145.0,18208
2021-05-30 15:00:00,Hispanic or Latino,1153,260634,1070.0,190547,105.0,18313
2021-05-31 15:00:00,Hispanic or Latino,301,260935,541.0,191088,43.0,18356
2021-06-01 15:00:00,Hispanic or Latino,1745,262680,2184.0,193272,155.0,18511
2021-06-02 15:00:00,Hispanic or Latino,2025,264705,2144.0,195416,123.0,18634
2021-06-03 15:00:00,Hispanic or Latino,1482,266187,2203.0,197619,122.0,18756
2021-06-04 15:00:00,Hispanic or Latino,1535,267722,3214.0,200833,132.0,18888
2021-06-05 15:00:00,Hispanic or Latino,1611,269333,2671.0,203504,122.0,19010
2021-06-06 15:00:00,Hispanic or Latino,988,270321,856.0,204360,87.0,19097
2021-06-07 15:00:00,Hispanic or Latino,1420,271741,1760.0,206120,102.0,19199
2021-06-08 15:00:00,Hispanic or Latino,1307,273048,2554.0,208674,115.0,19314
2021-06-09 15:00:00,Hispanic or Latino,1943,274991,3582.0,212256,141.0,19455
2021-06-10 15:00:00,Hispanic or Latino,1355,276346,2973.0,215229,110.0,19565
2021-06-11 15:00:00,Hispanic or Latino,1642,277988,2696.0,217925,191.0,19756
2021-06-12 15:00:00,Hispanic or Latino,1318,279306,3064.0,220989,116.0,19872
2021-06-13 15:00:00,Hispanic or Latino,550,279856,1477.0,222466,108.0,19980
2021-06-14 15:00:00,Hispanic or Latino,1255,281111,1803.0,224269,126.0,20106
2021-06-15 15:00:00,Hispanic or Latino,1033,282144,2249.0,226518,127.0,20233
2021-06-16 15:00:00,Hispanic or Latino,1411,283555,2640.0,229158,102.0,20335
2021-06-17 15:00:00,Hispanic or Latino,1373,284928,1822.0,230980,105.0,20440
2021-06-18 15:00:00,Hispanic or Latino,1383,286311,2082.0,233062,113.0,20553
2021-06-19 15:00:00,Hispanic or Latino,1067,287378,2053.0,235115,155.0,20708
2021-06-20 15:00:00,Hispanic or Latino,647,288025,1196.0,236311,131.0,20839
2021-06-21 15:00:00,Hispanic or Latino,1240,289265,810.0,237121,108.0,20947
2021-06-22 15:00:00,Hispanic or Latino,1113,290378,1655.0,238776,145.0,21092
2021-06-23 15:00:00,Hispanic or Latino,1294,291672,1891.0,240667,84.0,21176
2021-06-24 15:00:00,Hispanic or Latino,1118,292790,1271.0,241938,105.0,21281
2021-06-25 15:00:00,Hispanic or Latino,1032,293822,1430.0,243368,76.0,21357
2021-06-26 15:00:00,Hispanic or Latino,925,294747,1440.0,244808,114.0,21471
2021-06-27 15:00:00,Hispanic or Latino,699,295446,825.0,245633,64.0,21535
2021-06-28 15:00:00,Hispanic or Latino,894,296340,1212.0,246845,66.0,21601
2021-06-29 15:00:00,Hispanic or Latino,980,297320,1195.0,248040,112.0,21713
2021-06-30 15:00:00,Hispanic or Latino,1096,298416,1477.0,249517,93.0,21806
2021-07-01 15:00:00,Hispanic or Latino,900,299316,1151.0,250668,66.0,21872
2021-07-02 15:00:00,Hispanic or Latino,1117,300433,1369.0,252037,92.0,21964
2021-07-03 15:00:00,Hispanic or Latino,770,301203,878.0,252915,84.0,22048
2021-07-04 15:00:00,Hispanic or Latino,108,301311,96.0,253011,8.0,22056
2021-07-05 15:00:00,Hispanic or Latino,738,302049,797.0,253808,43.0,22099
2021-07-06 15:00:00,Hispanic or Latino,824,302873,1103.0,254911,51.0,22150
2021-07-07 15:00:00,Hispanic or Latino,837,303710,1241.0,256152,50.0,22200
2021-07-08 15:00:00,Hispanic or Latino,879,304589,1202.0,257354,69.0,22269
2021-07-09 15:00:00,Hispanic or Latino,1025,305614,1235.0,258589,80.0,22349
2021-07-10 15:00:00,Hispanic or Latino,849,306463,951.0,259540,45.0,22394
2021-07-11 15:00:00,Hispanic or Latino,829,307292,621.0,260161,72.0,22466
2021-07-12 15:00:00,Hispanic or Latino,794,308086,1040.0,261201,34.0,22500
2021-07-13 15:00:00,Hispanic or Latino,866,308952,899.0,262100,69.0,22569
2021-07-14 15:00:00,Hispanic or Latino,812,309764,1052.0,263152,52.0,22621
2021-07-15 15:00:00,Hispanic or Latino,841,310605,875.0,264027,34.0,22655
2021-07-16 15:00:00,Hispanic or Latino,874,311479,936.0,264963,69.0,22724
2021-07-17 15:00:00,Hispanic or Latino,648,312127,823.0,265786,72.0,22796
2021-07-18 15:00:00,Hispanic or Latino,134,312261,202.0,265988,26.0,22822
2021-07-17 15:00:00,Unknown,453,207931,149.0,177802,5.0,23568
2021-07-18 15:00:00,Unknown,83,208014,52.0,177854,9.0,23577
2020-12-14 15:00:00,Not Hispanic or Latino,9,9,,0,,0
2020-12-15 15:00:00,Not Hispanic or Latino,26,35,1.0,1,,0
2020-12-16 15:00:00,Not Hispanic or Latino,532,567,1.0,2,,0
2020-12-17 15:00:00,Not Hispanic or Latino,1049,1616,1.0,3,,0
2020-12-18 15:00:00,Not Hispanic or Latino,2784,4400,5.0,8,,0
2020-12-19 15:00:00,Not Hispanic or Latino,831,5231,2.0,10,,0
2020-12-20 15:00:00,Not Hispanic or Latino,259,5490,3.0,13,,0
2020-12-21 15:00:00,Not Hispanic or Latino,3590,9080,8.0,21,,0
2020-12-22 15:00:00,Not Hispanic or Latino,5618,14698,7.0,28,,0
2020-12-23 15:00:00,Not Hispanic or Latino,5291,19989,14.0,42,,0
2020-12-24 15:00:00,Not Hispanic or Latino,2519,22508,6.0,48,,0
2020-12-25 15:00:00,Not Hispanic or Latino,814,23322,2.0,50,,0
2020-12-26 15:00:00,Not Hispanic or Latino,1602,24924,4.0,54,,0
2020-12-27 15:00:00,Not Hispanic or Latino,1577,26501,6.0,60,,0
2020-12-28 15:00:00,Not Hispanic or Latino,8317,34818,19.0,79,,0
2020-12-29 15:00:00,Not Hispanic or Latino,10007,44825,12.0,91,,0
2020-12-30 15:00:00,Not Hispanic or Latino,11506,56331,34.0,125,,0
2020-12-31 15:00:00,Not Hispanic or Latino,6922,63253,16.0,141,,0
2021-01-01 15:00:00,Not Hispanic or Latino,1727,64980,45.0,186,,0
2021-01-02 15:00:00,Not Hispanic or Latino,2634,67614,23.0,209,,0
2021-01-03 15:00:00,Not Hispanic or Latino,2971,70585,65.0,274,,0
2021-01-04 15:00:00,Not Hispanic or Latino,11931,82516,262.0,536,,0
2021-01-05 15:00:00,Not Hispanic or Latino,11351,93867,439.0,975,,0
2021-01-06 15:00:00,Not Hispanic or Latino,13775,107642,754.0,1729,,0
2021-01-07 15:00:00,Not Hispanic or Latino,13626,121268,1546.0,3275,,0
2021-01-08 15:00:00,Not Hispanic or Latino,14637,135905,2505.0,5780,,0
2021-01-09 15:00:00,Not Hispanic or Latino,4629,140534,836.0,6616,,0
2021-01-10 15:00:00,Not Hispanic or Latino,2528,143062,323.0,6939,,0
2021-01-11 15:00:00,Not Hispanic or Latino,12674,155736,3136.0,10075,,0
2021-01-12 15:00:00,Not Hispanic or Latino,15706,171442,4958.0,15033,,0
2021-01-13 15:00:00,Not Hispanic or Latino,17269,188711,3519.0,18552,,0
2021-01-14 15:00:00,Not Hispanic or Latino,16512,205223,1737.0,20289,,0
2021-01-15 15:00:00,Not Hispanic or Latino,17843,223066,1621.0,21910,,0
2021-01-16 15:00:00,Not Hispanic or Latino,5201,228267,1353.0,23263,,0
2021-01-17 15:00:00,Not Hispanic or Latino,1845,230112,1316.0,24579,,0
2021-01-18 15:00:00,Not Hispanic or Latino,6642,236754,2873.0,27452,,0
2021-01-19 15:00:00,Not Hispanic or Latino,16215,252969,4800.0,32252,,0
2021-01-20 15:00:00,Not Hispanic or Latino,20080,273049,4765.0,37017,,0
2021-01-21 15:00:00,Not Hispanic or Latino,22389,295438,3342.0,40359,,0
2021-01-22 15:00:00,Not Hispanic or Latino,27007,322445,3205.0,43564,,0
2021-01-23 15:00:00,Not Hispanic or Latino,9158,331603,1619.0,45183,,0
2021-01-24 15:00:00,Not Hispanic or Latino,2997,334600,1487.0,46670,,0
2021-01-25 15:00:00,Not Hispanic or Latino,15550,350150,7592.0,54262,,0
2021-01-26 15:00:00,Not Hispanic or Latino,16629,366779,8171.0,62433,,0
2021-01-27 15:00:00,Not Hispanic or Latino,23612,390391,11266.0,73699,,0
2021-01-28 15:00:00,Not Hispanic or Latino,21821,412212,8406.0,82105,,0
2021-01-29 15:00:00,Not Hispanic or Latino,24041,436253,7137.0,89242,,0
2021-01-30 15:00:00,Not Hispanic or Latino,17345,453598,2251.0,91493,,0
2021-01-31 15:00:00,Not Hispanic or Latino,3500,457098,1135.0,92628,,0
2021-02-01 15:00:00,Not Hispanic or Latino,6488,463586,4253.0,96881,,0
2021-02-02 15:00:00,Not Hispanic or Latino,11579,475165,12300.0,109181,,0
2021-02-03 15:00:00,Not Hispanic or Latino,17144,492309,16777.0,125958,,0
2021-02-04 15:00:00,Not Hispanic or Latino,20708,513017,14363.0,140321,,0
2021-02-05 15:00:00,Not Hispanic or Latino,18919,531936,15914.0,156235,,0
2021-02-06 15:00:00,Not Hispanic or Latino,11042,542978,5865.0,162100,,0
2021-02-07 15:00:00,Not Hispanic or Latino,5367,548345,1555.0,163655,,0
2021-02-08 15:00:00,Not Hispanic or Latino,11873,560218,12009.0,175664,,0
2021-02-09 15:00:00,Not Hispanic or Latino,15255,575473,12981.0,188645,,0
2021-02-10 15:00:00,Not Hispanic or Latino,17670,593143,20070.0,208715,,0
2021-02-11 15:00:00,Not Hispanic or Latino,21066,614209,16155.0,224870,,0
2021-02-12 15:00:00,Not Hispanic or Latino,18762,632971,18241.0,243111,,0
2021-02-13 15:00:00,Not Hispanic or Latino,10553,643524,5842.0,248953,,0
2021-02-14 15:00:00,Not Hispanic or Latino,6334,649858,1826.0,250779,,0
2021-02-15 15:00:00,Not Hispanic or Latino,10857,660715,12182.0,262961,,0
2021-02-16 15:00:00,Not Hispanic or Latino,15269,675984,20202.0,283163,,0
2021-02-17 15:00:00,Not Hispanic or Latino,19069,695053,25607.0,308770,,0
2021-02-18 15:00:00,Not Hispanic or Latino,2764,697817,4248.0,313018,,0
2021-02-19 15:00:00,Not Hispanic or Latino,9350,707167,18962.0,331980,,0
2021-02-20 15:00:00,Not Hispanic or Latino,9343,716510,19471.0,351451,,0
2021-02-21 15:00:00,Not Hispanic or Latino,5446,721956,7193.0,358644,,0
2021-02-22 15:00:00,Not Hispanic or Latino,7299,729255,14788.0,373432,,0
2021-02-23 15:00:00,Not Hispanic or Latino,14325,743580,15316.0,388748,,0
2021-02-24 15:00:00,Not Hispanic or Latino,16727,760307,23599.0,412347,,0
2021-02-25 15:00:00,Not Hispanic or Latino,18943,779250,25069.0,437416,,0
2021-02-26 15:00:00,Not Hispanic or Latino,24851,804101,24535.0,461951,,0
2021-02-27 15:00:00,Not Hispanic or Latino,14794,818895,10811.0,472762,,0
2021-02-28 15:00:00,Not Hispanic or Latino,14082,832977,4318.0,477080,,0
2021-03-01 15:00:00,Not Hispanic or Latino,22929,855906,11116.0,488196,,0
2021-03-02 15:00:00,Not Hispanic or Latino,21945,877851,12217.0,500413,23.0,23
2021-03-03 15:00:00,Not Hispanic or Latino,27777,905628,16870.0,517283,141.0,164
2021-03-04 15:00:00,Not Hispanic or Latino,28601,934229,16769.0,534052,3815.0,3979
2021-03-05 15:00:00,Not Hispanic or Latino,26689,960918,17959.0,552011,4604.0,8583
2021-03-06 15:00:00,Not Hispanic or Latino,16127,977045,8215.0,560226,5402.0,13985
2021-03-07 15:00:00,Not Hispanic or Latino,10916,987961,4209.0,564435,5995.0,19980
2021-03-08 15:00:00,Not Hispanic or Latino,23828,1011789,7935.0,572370,7548.0,27528
2021-03-09 15:00:00,Not Hispanic or Latino,24084,1035873,14270.0,586640,7509.0,35037
2021-03-10 15:00:00,Not Hispanic or Latino,27689,1063562,14607.0,601247,6910.0,41947
2021-03-11 15:00:00,Not Hispanic or Latino,33085,1096647,15042.0,616289,3568.0,45515
2021-03-12 15:00:00,Not Hispanic or Latino,33690,1130337,16583.0,632872,2521.0,48036
2021-03-13 15:00:00,Not Hispanic or Latino,20448,1150785,9359.0,642231,1296.0,49332
2021-03-14 15:00:00,Not Hispanic or Latino,15254,1166039,6016.0,648247,805.0,50137
2021-03-15 15:00:00,Not Hispanic or Latino,26304,1192343,10373.0,658620,498.0,50635
2021-03-16 15:00:00,Not Hispanic or Latino,29763,1222106,12292.0,670912,703.0,51338
2021-03-17 15:00:00,Not Hispanic or Latino,33408,1255514,15479.0,686391,1042.0,52380
2021-03-18 15:00:00,Not Hispanic or Latino,36941,1292455,11540.0,697931,1192.0,53572
2021-03-19 15:00:00,Not Hispanic or Latino,33937,1326392,14313.0,712244,897.0,54469
2021-03-20 15:00:00,Not Hispanic or Latino,20958,1347350,8996.0,721240,911.0,55380
2021-03-21 15:00:00,Not Hispanic or Latino,16349,1363699,6746.0,727986,280.0,55660
2021-03-22 15:00:00,Not Hispanic or Latino,28713,1392412,10406.0,738392,761.0,56421
2021-03-23 15:00:00,Not Hispanic or Latino,33085,1425497,15982.0,754374,1331.0,57752
2021-03-24 15:00:00,Not Hispanic or Latino,35246,1460743,19508.0,773882,1089.0,58841
2021-03-25 15:00:00,Not Hispanic or Latino,36403,1497146,19309.0,793191,2074.0,60915
2021-03-26 15:00:00,Not Hispanic or Latino,31402,1528548,24105.0,817296,1951.0,62866
2021-03-27 15:00:00,Not Hispanic or Latino,23453,1552001,15391.0,832687,2114.0,64980
2021-03-28 15:00:00,Not Hispanic or Latino,14027,1566028,11430.0,844117,1130.0,66110
2021-03-29 15:00:00,Not Hispanic or Latino,25110,1591138,24010.0,868127,998.0,67108
2021-03-30 15:00:00,Not Hispanic or Latino,34749,1625887,26670.0,894797,1606.0,68714
2021-03-31 15:00:00,Not Hispanic or Latino,35078,1660965,32264.0,927061,4567.0,73281
2021-04-01 15:00:00,Not Hispanic or Latino,35369,1696334,35956.0,963017,4609.0,77890
2021-04-02 15:00:00,Not Hispanic or Latino,30125,1726459,29168.0,992185,4995.0,82885
2021-04-03 15:00:00,Not Hispanic or Latino,17768,1744227,16618.0,1008803,3483.0,86368
2021-04-04 15:00:00,Not Hispanic or Latino,6953,1751180,8861.0,1017664,853.0,87221
2021-04-05 15:00:00,Not Hispanic or Latino,23698,1774878,26083.0,1043747,5600.0,92821
2021-04-06 15:00:00,Not Hispanic or Latino,34535,1809413,27255.0,1071002,9095.0,101916
2021-04-07 15:00:00,Not Hispanic or Latino,30083,1839496,30799.0,1101801,10733.0,112649
2021-04-08 15:00:00,Not Hispanic or Latino,35945,1875441,32386.0,1134187,11155.0,123804
2021-04-09 15:00:00,Not Hispanic or Latino,27551,1902992,32728.0,1166915,12108.0,135912
2021-04-10 15:00:00,Not Hispanic or Latino,18820,1921812,20209.0,1187124,6043.0,141955
2021-04-11 15:00:00,Not Hispanic or Latino,12933,1934745,10798.0,1197922,8926.0,150881
2021-04-12 15:00:00,Not Hispanic or Latino,19750,1954495,28968.0,1226890,9082.0,159963
2021-04-13 15:00:00,Not Hispanic or Latino,35719,1990214,31800.0,1258690,278.0,160241
2021-04-14 15:00:00,Not Hispanic or Latino,32631,2022845,32806.0,1291496,159.0,160400
2021-04-15 15:00:00,Not Hispanic or Latino,33671,2056516,33479.0,1324975,112.0,160512
2021-04-16 15:00:00,Not Hispanic or Latino,29389,2085905,32338.0,1357313,10.0,160522
2021-04-17 15:00:00,Not Hispanic or Latino,24447,2110352,17169.0,1374482,4.0,160526
2021-04-18 15:00:00,Not Hispanic or Latino,14696,2125048,13247.0,1387729,3.0,160529
2021-04-19 15:00:00,Not Hispanic or Latino,22418,2147466,30016.0,1417745,44.0,160573
2021-04-20 15:00:00,Not Hispanic or Latino,23957,2171423,37057.0,1454802,35.0,160608
2021-04-21 15:00:00,Not Hispanic or Latino,30504,2201927,38700.0,1493502,13.0,160621
2021-04-22 15:00:00,Not Hispanic or Latino,28626,2230553,36028.0,1529530,13.0,160634
2021-04-23 15:00:00,Not Hispanic or Latino,24982,2255535,33725.0,1563255,9.0,160643
2021-04-24 15:00:00,Not Hispanic or Latino,18950,2274485,24047.0,1587302,66.0,160709
2021-04-25 15:00:00,Not Hispanic or Latino,13954,2288439,6747.0,1594049,22.0,160731
2021-04-26 15:00:00,Not Hispanic or Latino,20519,2308958,26838.0,1620887,173.0,160904
2021-04-27 15:00:00,Not Hispanic or Latino,20864,2329822,28693.0,1649580,905.0,161809
2021-04-28 15:00:00,Not Hispanic or Latino,23192,2353014,32942.0,1682522,1121.0,162930
2021-04-29 15:00:00,Not Hispanic or Latino,21667,2374681,32315.0,1714837,1217.0,164147
2021-04-30 15:00:00,Not Hispanic or Latino,21899,2396580,26243.0,1741080,1341.0,165488
2021-05-01 15:00:00,Not Hispanic or Latino,13413,2409993,18879.0,1759959,790.0,166278
2021-05-02 15:00:00,Not Hispanic or Latino,6351,2416344,11212.0,1771171,651.0,166929
2021-05-03 15:00:00,Not Hispanic or Latino,9859,2426203,22266.0,1793437,1580.0,168509
2021-05-04 15:00:00,Not Hispanic or Latino,11461,2437664,33003.0,1826440,1449.0,169958
2021-05-05 15:00:00,Not Hispanic or Latino,14564,2452228,29869.0,1856309,1572.0,171530
2021-05-06 15:00:00,Not Hispanic or Latino,13277,2465505,31958.0,1888267,1444.0,172974
2021-05-07 15:00:00,Not Hispanic or Latino,12851,2478356,28243.0,1916510,1628.0,174602
2021-05-08 15:00:00,Not Hispanic or Latino,7447,2485803,23328.0,1939838,1003.0,175605
2021-05-09 15:00:00,Not Hispanic or Latino,3416,2489219,8811.0,1948649,554.0,176159
2021-05-10 15:00:00,Not Hispanic or Latino,6659,2495878,23298.0,1971947,1130.0,177289
2021-05-11 15:00:00,Not Hispanic or Latino,9584,2505462,24658.0,1996605,1202.0,178491
2021-05-12 15:00:00,Not Hispanic or Latino,10584,2516046,30155.0,2026760,1397.0,179888
2021-05-13 15:00:00,Not Hispanic or Latino,18177,2534223,27431.0,2054191,1091.0,180979
2021-05-14 15:00:00,Not Hispanic or Latino,19478,2553701,23232.0,2077423,1392.0,182371
2021-05-15 15:00:00,Not Hispanic or Latino,16415,2570116,17298.0,2094721,1041.0,183412
2021-05-16 15:00:00,Not Hispanic or Latino,7077,2577193,13005.0,2107726,709.0,184121
2021-05-17 15:00:00,Not Hispanic or Latino,13726,2590919,20832.0,2128558,1514.0,185635
2021-05-18 15:00:00,Not Hispanic or Latino,17155,2608074,24140.0,2152698,1513.0,187148
2021-05-19 15:00:00,Not Hispanic or Latino,22225,2630299,25625.0,2178323,1220.0,188368
2021-05-20 15:00:00,Not Hispanic or Latino,15741,2646040,26005.0,2204328,1560.0,189928
2021-05-21 15:00:00,Not Hispanic or Latino,15276,2661316,23544.0,2227872,1191.0,191119
2021-05-22 15:00:00,Not Hispanic or Latino,11526,2672842,14481.0,2242353,782.0,191901
2021-05-23 15:00:00,Not Hispanic or Latino,6296,2679138,8042.0,2250395,596.0,192497
2021-05-24 15:00:00,Not Hispanic or Latino,10300,2689438,13446.0,2263841,1067.0,193564
2021-05-25 15:00:00,Not Hispanic or Latino,9944,2699382,15339.0,2279180,1026.0,194590
2021-05-26 15:00:00,Not Hispanic or Latino,14487,2713869,15319.0,2294499,1162.0,195752
2021-05-27 15:00:00,Not Hispanic or Latino,8930,2722799,14445.0,2308944,868.0,196620
2021-05-28 15:00:00,Not Hispanic or Latino,9284,2732083,14821.0,2323765,1022.0,197642
2021-05-29 15:00:00,Not Hispanic or Latino,6144,2738227,7709.0,2331474,551.0,198193
2021-05-30 15:00:00,Not Hispanic or Latino,3368,2741595,4512.0,2335986,351.0,198544
2021-05-31 15:00:00,Not Hispanic or Latino,1189,2742784,2647.0,2338633,185.0,198729
2021-06-01 15:00:00,Not Hispanic or Latino,6993,2749777,13173.0,2351806,838.0,199567
2021-06-02 15:00:00,Not Hispanic or Latino,7509,2757286,13514.0,2365320,744.0,200311
2021-06-03 15:00:00,Not Hispanic or Latino,6003,2763289,17806.0,2383126,853.0,201164
2021-06-04 15:00:00,Not Hispanic or Latino,6306,2769595,17607.0,2400733,851.0,202015
2021-06-05 15:00:00,Not Hispanic or Latino,4926,2774521,15406.0,2416139,547.0,202562
2021-06-06 15:00:00,Not Hispanic or Latino,2244,2776765,5794.0,2421933,256.0,202818
2021-06-07 15:00:00,Not Hispanic or Latino,5044,2781809,13428.0,2435361,569.0,203387
2021-06-08 15:00:00,Not Hispanic or Latino,5030,2786839,16238.0,2451599,613.0,204000
2021-06-09 15:00:00,Not Hispanic or Latino,5717,2792556,19215.0,2470814,743.0,204743
2021-06-10 15:00:00,Not Hispanic or Latino,5345,2797901,15053.0,2485867,708.0,205451
2021-06-11 15:00:00,Not Hispanic or Latino,5219,2803120,13877.0,2499744,818.0,206269
2021-06-12 15:00:00,Not Hispanic or Latino,3421,2806541,10450.0,2510194,402.0,206671
2021-06-13 15:00:00,Not Hispanic or Latino,1156,2807697,5539.0,2515733,261.0,206932
2021-06-14 15:00:00,Not Hispanic or Latino,4079,2811776,9494.0,2525227,529.0,207461
2021-06-15 15:00:00,Not Hispanic or Latino,4153,2815929,11135.0,2536362,601.0,208062
2021-06-16 15:00:00,Not Hispanic or Latino,4869,2820798,14406.0,2550768,521.0,208583
2021-06-17 15:00:00,Not Hispanic or Latino,4816,2825614,9608.0,2560376,505.0,209088
2021-06-18 15:00:00,Not Hispanic or Latino,4685,2830299,9265.0,2569641,507.0,209595
2021-06-19 15:00:00,Not Hispanic or Latino,2869,2833168,5891.0,2575532,403.0,209998
2021-06-20 15:00:00,Not Hispanic or Latino,1323,2834491,3045.0,2578577,207.0,210205
2021-06-21 15:00:00,Not Hispanic or Latino,3868,2838359,4118.0,2582695,489.0,210694
2021-06-22 15:00:00,Not Hispanic or Latino,3620,2841979,6578.0,2589273,438.0,211132
2021-06-23 15:00:00,Not Hispanic or Latino,4288,2846267,7772.0,2597045,488.0,211620
2021-06-24 15:00:00,Not Hispanic or Latino,4066,2850333,6129.0,2603174,429.0,212049
2021-06-25 15:00:00,Not Hispanic or Latino,3848,2854181,5965.0,2609139,474.0,212523
2021-06-26 15:00:00,Not Hispanic or Latino,2463,2856644,4372.0,2613511,205.0,212728
2021-06-27 15:00:00,Not Hispanic or Latino,1612,2858256,2305.0,2615816,100.0,212828
2021-06-28 15:00:00,Not Hispanic or Latino,3191,2861447,4324.0,2620140,410.0,213238
2021-06-29 15:00:00,Not Hispanic or Latino,3569,2865016,4874.0,2625014,334.0,213572
2021-06-30 15:00:00,Not Hispanic or Latino,3974,2868990,5456.0,2630470,459.0,214031
2021-07-01 15:00:00,Not Hispanic or Latino,3557,2872547,4939.0,2635409,337.0,214368
2021-07-02 15:00:00,Not Hispanic or Latino,3506,2876053,4726.0,2640135,370.0,214738
2021-07-03 15:00:00,Not Hispanic or Latino,2058,2878111,2748.0,2642883,149.0,214887
2021-07-04 15:00:00,Not Hispanic or Latino,265,2878376,325.0,2643208,45.0,214932
2021-07-05 15:00:00,Not Hispanic or Latino,2586,2880962,2870.0,2646078,215.0,215147
2021-07-06 15:00:00,Not Hispanic or Latino,3240,2884202,4714.0,2650792,321.0,215468
2021-07-07 15:00:00,Not Hispanic or Latino,3195,2887397,4705.0,2655497,342.0,215810
2021-07-08 15:00:00,Not Hispanic or Latino,3310,2890707,4282.0,2659779,351.0,216161
2021-07-09 15:00:00,Not Hispanic or Latino,3712,2894419,4583.0,2664362,370.0,216531
2021-07-10 15:00:00,Not Hispanic or Latino,2303,2896722,2838.0,2667200,203.0,216734
2021-07-11 15:00:00,Not Hispanic or Latino,1413,2898135,1464.0,2668664,120.0,216854
2021-07-12 15:00:00,Not Hispanic or Latino,3227,2901362,3699.0,2672363,306.0,217160
2021-07-13 15:00:00,Not Hispanic or Latino,3393,2904755,3307.0,2675670,250.0,217410
2021-07-14 15:00:00,Not Hispanic or Latino,3136,2907891,3643.0,2679313,305.0,217715
2021-07-15 15:00:00,Not Hispanic or Latino,3318,2911209,3482.0,2682795,246.0,217961
2021-07-16 15:00:00,Not Hispanic or Latino,3705,2914914,3528.0,2686323,223.0,218184
2021-07-17 15:00:00,Not Hispanic or Latino,2006,2916920,2120.0,2688443,94.0,218278
2021-07-18 15:00:00,Not Hispanic or Latino,430,2917350,498.0,2688941,22.0,218300
