VACCINATION_DATE,Ethnicity,FirstDoseDaily,FirstDoseCumulative,SecondDoseDaily,SecondDoseCumulative,SingleDoseDaily,SingleDoseCumulative
2020-12-14 15:00:00,Unknown,1,1,,0,,0
2020-12-16 15:00:00,Unknown,9,10,,0,,0
2020-12-17 15:00:00,Unknown,16,26,,0,,0
2020-12-18 15:00:00,Unknown,90,116,,0,,0
2020-12-19 15:00:00,Unknown,26,142,,0,,0
2020-12-20 15:00:00,Unknown,32,174,,0,,0
2020-12-21 15:00:00,Unknown,72,246,,0,,0
2020-12-22 15:00:00,Unknown,453,699,,0,,0
2020-12-23 15:00:00,Unknown,196,895,,0,,0
2020-12-24 15:00:00,Unknown,66,961,,0,,0
2020-12-25 15:00:00,Unknown,199,1160,,0,,0
2020-12-26 15:00:00,Unknown,214,1374,,0,,0
2020-12-27 15:00:00,Unknown,153,1527,,0,,0
2020-12-28 15:00:00,Unknown,295,1822,,0,,0
2020-12-29 15:00:00,Unknown,508,2330,,0,,0
2020-12-30 15:00:00,Unknown,360,2690,,0,,0
2020-12-31 15:00:00,Unknown,211,2901,1.0,1,,0
2021-01-01 15:00:00,Unknown,164,3065,,1,,0
2021-01-02 15:00:00,Unknown,190,3255,1.0,2,,0
2021-01-03 15:00:00,Unknown,266,3521,4.0,6,,0
2021-01-04 15:00:00,Unknown,722,4243,6.0,12,,0
2021-01-05 15:00:00,Unknown,549,4792,17.0,29,,0
2021-01-06 15:00:00,Unknown,644,5436,22.0,51,,0
2021-01-07 15:00:00,Unknown,434,5870,56.0,107,,0
2021-01-08 15:00:00,Unknown,8282,14152,74.0,181,,0
2021-01-09 15:00:00,Unknown,214,14366,41.0,222,,0
2021-01-10 15:00:00,Unknown,174,14540,10.0,232,,0
2021-01-11 15:00:00,Unknown,342,14882,83.0,315,,0
2021-01-12 15:00:00,Unknown,734,15616,368.0,683,,0
2021-01-13 15:00:00,Unknown,428,16044,140.0,823,,0
2021-01-14 15:00:00,Unknown,371,16415,58.0,881,,0
2021-01-15 15:00:00,Unknown,543,16958,189.0,1070,,0
2021-01-16 15:00:00,Unknown,316,17274,170.0,1240,,0
2021-01-17 15:00:00,Unknown,110,17384,110.0,1350,,0
2021-01-18 15:00:00,Unknown,188,17572,231.0,1581,,0
2021-01-19 15:00:00,Unknown,294,17866,259.0,1840,,0
2021-01-20 15:00:00,Unknown,339,18205,148.0,1988,,0
2021-01-21 15:00:00,Unknown,356,18561,65.0,2053,,0
2021-01-22 15:00:00,Unknown,748,19309,218.0,2271,,0
2021-01-23 15:00:00,Unknown,435,19744,167.0,2438,,0
2021-01-24 15:00:00,Unknown,223,19967,177.0,2615,,0
2021-01-25 15:00:00,Unknown,585,20552,521.0,3136,,0
2021-01-26 15:00:00,Unknown,667,21219,367.0,3503,,0
2021-01-27 15:00:00,Unknown,524,21743,564.0,4067,,0
2021-01-28 15:00:00,Unknown,479,22222,280.0,4347,,0
2021-01-29 15:00:00,Unknown,378,22600,160.0,4507,,0
2021-01-30 15:00:00,Unknown,312,22912,42.0,4549,,0
2021-01-31 15:00:00,Unknown,373,23285,91.0,4640,,0
2021-02-01 15:00:00,Unknown,414,23699,190.0,4830,,0
2021-02-02 15:00:00,Unknown,534,24233,622.0,5452,,0
2021-02-03 15:00:00,Unknown,704,24937,516.0,5968,,0
2021-02-04 15:00:00,Unknown,882,25819,403.0,6371,,0
2021-02-05 15:00:00,Unknown,697,26516,413.0,6784,,0
2021-02-06 15:00:00,Unknown,407,26923,216.0,7000,,0
2021-02-07 15:00:00,Unknown,402,27325,86.0,7086,,0
2021-02-08 15:00:00,Unknown,692,28017,242.0,7328,,0
2021-02-09 15:00:00,Unknown,775,28792,299.0,7627,,0
2021-02-10 15:00:00,Unknown,862,29654,409.0,8036,,0
2021-02-11 15:00:00,Unknown,934,30588,384.0,8420,,0
2021-02-12 15:00:00,Unknown,734,31322,558.0,8978,,0
2021-02-13 15:00:00,Unknown,391,31713,154.0,9132,,0
2021-02-14 15:00:00,Unknown,455,32168,146.0,9278,,0
2021-02-15 15:00:00,Unknown,484,32652,509.0,9787,,0
2021-02-16 15:00:00,Unknown,744,33396,681.0,10468,,0
2021-02-17 15:00:00,Unknown,866,34262,463.0,10931,,0
2021-02-18 15:00:00,Unknown,322,34584,234.0,11165,,0
2021-02-19 15:00:00,Unknown,660,35244,420.0,11585,,0
2021-02-20 15:00:00,Unknown,501,35745,368.0,11953,,0
2021-02-21 15:00:00,Unknown,358,36103,270.0,12223,,0
2021-02-22 15:00:00,Unknown,487,36590,420.0,12643,,0
2021-02-23 15:00:00,Unknown,736,37326,352.0,12995,,0
2021-02-24 15:00:00,Unknown,691,38017,508.0,13503,,0
2021-02-25 15:00:00,Unknown,704,38721,821.0,14324,,0
2021-02-26 15:00:00,Unknown,797,39518,675.0,14999,,0
2021-02-27 15:00:00,Unknown,622,40140,265.0,15264,,0
2021-02-28 15:00:00,Unknown,832,40972,153.0,15417,,0
2021-03-01 15:00:00,Unknown,1105,42077,474.0,15891,,0
2021-03-02 15:00:00,Unknown,1262,43339,518.0,16409,,0
2021-03-03 15:00:00,Unknown,1658,44997,602.0,17011,2.0,2
2021-03-04 15:00:00,Unknown,1744,46741,671.0,17682,50.0,52
2021-03-05 15:00:00,Unknown,1396,48137,562.0,18244,48.0,100
2021-03-06 15:00:00,Unknown,948,49085,311.0,18555,189.0,289
2021-03-07 15:00:00,Unknown,1233,50318,323.0,18878,309.0,598
2021-03-08 15:00:00,Unknown,1118,51436,343.0,19221,380.0,978
2021-03-09 15:00:00,Unknown,1200,52636,460.0,19681,393.0,1371
2021-03-10 15:00:00,Unknown,1042,53678,518.0,20199,517.0,1888
2021-03-11 15:00:00,Unknown,1256,54934,524.0,20723,149.0,2037
2021-03-12 15:00:00,Unknown,1478,56412,538.0,21261,105.0,2142
2021-03-13 15:00:00,Unknown,976,57388,334.0,21595,44.0,2186
2021-03-14 15:00:00,Unknown,1081,58469,313.0,21908,48.0,2234
2021-03-15 15:00:00,Unknown,1957,60426,404.0,22312,31.0,2265
2021-03-16 15:00:00,Unknown,2020,62446,575.0,22887,45.0,2310
2021-03-17 15:00:00,Unknown,1998,64444,695.0,23582,61.0,2371
2021-03-18 15:00:00,Unknown,2276,66720,458.0,24040,52.0,2423
2021-03-19 15:00:00,Unknown,1792,68512,402.0,24442,48.0,2471
2021-03-20 15:00:00,Unknown,1525,70037,448.0,24890,38.0,2509
2021-03-21 15:00:00,Unknown,1068,71105,223.0,25113,18.0,2527
2021-03-22 15:00:00,Unknown,2004,73109,501.0,25614,34.0,2561
2021-03-23 15:00:00,Unknown,2511,75620,617.0,26231,76.0,2637
2021-03-24 15:00:00,Unknown,3104,78724,511.0,26742,72.0,2709
2021-03-25 15:00:00,Unknown,3111,81835,577.0,27319,325.0,3034
2021-03-26 15:00:00,Unknown,2940,84775,654.0,27973,373.0,3407
2021-03-27 15:00:00,Unknown,2177,86952,508.0,28481,414.0,3821
2021-03-28 15:00:00,Unknown,2109,89061,504.0,28985,451.0,4272
2021-03-29 15:00:00,Unknown,3017,92078,880.0,29865,73.0,4345
2021-03-30 15:00:00,Unknown,3065,95143,844.0,30709,134.0,4479
2021-03-31 15:00:00,Unknown,3135,98278,450.0,31159,1056.0,5535
2020-12-15 15:00:00,Hispanic or Latino,1,1,,0,,0
2020-12-16 15:00:00,Hispanic or Latino,20,21,,0,,0
2020-12-17 15:00:00,Hispanic or Latino,31,52,,0,,0
2020-12-18 15:00:00,Hispanic or Latino,85,137,,0,,0
2020-12-19 15:00:00,Hispanic or Latino,33,170,,0,,0
2020-12-20 15:00:00,Hispanic or Latino,9,179,,0,,0
2020-12-21 15:00:00,Hispanic or Latino,144,323,1.0,1,,0
2020-12-22 15:00:00,Hispanic or Latino,252,575,,1,,0
2020-12-23 15:00:00,Hispanic or Latino,175,750,1.0,2,,0
2020-12-24 15:00:00,Hispanic or Latino,85,835,,2,,0
2020-12-25 15:00:00,Hispanic or Latino,38,873,,2,,0
2020-12-26 15:00:00,Hispanic or Latino,37,910,,2,,0
2020-12-27 15:00:00,Hispanic or Latino,58,968,,2,,0
2020-12-28 15:00:00,Hispanic or Latino,251,1219,,2,,0
2020-12-29 15:00:00,Hispanic or Latino,347,1566,,2,,0
2020-12-30 15:00:00,Hispanic or Latino,502,2068,,2,,0
2020-12-31 15:00:00,Hispanic or Latino,311,2379,,2,,0
2021-01-01 15:00:00,Hispanic or Latino,35,2414,,2,,0
2021-01-02 15:00:00,Hispanic or Latino,76,2490,2.0,4,,0
2021-01-03 15:00:00,Hispanic or Latino,115,2605,3.0,7,,0
2021-01-04 15:00:00,Hispanic or Latino,610,3215,12.0,19,,0
2021-01-05 15:00:00,Hispanic or Latino,398,3613,17.0,36,,0
2021-01-06 15:00:00,Hispanic or Latino,562,4175,20.0,56,,0
2021-01-07 15:00:00,Hispanic or Latino,795,4970,56.0,112,,0
2021-01-08 15:00:00,Hispanic or Latino,860,5830,89.0,201,,0
2021-01-09 15:00:00,Hispanic or Latino,195,6025,32.0,233,,0
2021-01-10 15:00:00,Hispanic or Latino,132,6157,19.0,252,,0
2021-01-11 15:00:00,Hispanic or Latino,545,6702,122.0,374,,0
2021-01-12 15:00:00,Hispanic or Latino,720,7422,201.0,575,,0
2021-01-13 15:00:00,Hispanic or Latino,657,8079,126.0,701,,0
2021-01-14 15:00:00,Hispanic or Latino,742,8821,60.0,761,,0
2021-01-15 15:00:00,Hispanic or Latino,857,9678,68.0,829,,0
2021-01-16 15:00:00,Hispanic or Latino,176,9854,40.0,869,,0
2021-01-17 15:00:00,Hispanic or Latino,99,9953,37.0,906,,0
2021-01-18 15:00:00,Hispanic or Latino,169,10122,107.0,1013,,0
2021-01-19 15:00:00,Hispanic or Latino,456,10578,139.0,1152,,0
2021-01-20 15:00:00,Hispanic or Latino,610,11188,170.0,1322,,0
2021-01-21 15:00:00,Hispanic or Latino,742,11930,107.0,1429,,0
2021-01-22 15:00:00,Hispanic or Latino,947,12877,99.0,1528,,0
2021-01-23 15:00:00,Hispanic or Latino,322,13199,47.0,1575,,0
2021-01-24 15:00:00,Hispanic or Latino,95,13294,32.0,1607,,0
2021-01-25 15:00:00,Hispanic or Latino,363,13657,299.0,1906,,0
2021-01-26 15:00:00,Hispanic or Latino,502,14159,222.0,2128,,0
2021-01-27 15:00:00,Hispanic or Latino,730,14889,420.0,2548,,0
2021-01-28 15:00:00,Hispanic or Latino,785,15674,388.0,2936,,0
2021-01-29 15:00:00,Hispanic or Latino,681,16355,283.0,3219,,0
2021-01-30 15:00:00,Hispanic or Latino,480,16835,89.0,3308,,0
2021-01-31 15:00:00,Hispanic or Latino,133,16968,25.0,3333,,0
2021-02-01 15:00:00,Hispanic or Latino,151,17119,144.0,3477,,0
2021-02-02 15:00:00,Hispanic or Latino,406,17525,586.0,4063,,0
2021-02-03 15:00:00,Hispanic or Latino,605,18130,664.0,4727,,0
2021-02-04 15:00:00,Hispanic or Latino,721,18851,695.0,5422,,0
2021-02-05 15:00:00,Hispanic or Latino,759,19610,853.0,6275,,0
2021-02-06 15:00:00,Hispanic or Latino,379,19989,198.0,6473,,0
2021-02-07 15:00:00,Hispanic or Latino,165,20154,56.0,6529,,0
2021-02-08 15:00:00,Hispanic or Latino,514,20668,585.0,7114,,0
2021-02-09 15:00:00,Hispanic or Latino,548,21216,513.0,7627,,0
2021-02-10 15:00:00,Hispanic or Latino,681,21897,670.0,8297,,0
2021-02-11 15:00:00,Hispanic or Latino,853,22750,714.0,9011,,0
2021-02-12 15:00:00,Hispanic or Latino,755,23505,824.0,9835,,0
2021-02-13 15:00:00,Hispanic or Latino,358,23863,222.0,10057,,0
2021-02-14 15:00:00,Hispanic or Latino,273,24136,61.0,10118,,0
2021-02-15 15:00:00,Hispanic or Latino,312,24448,346.0,10464,,0
2021-02-16 15:00:00,Hispanic or Latino,501,24949,533.0,10997,,0
2021-02-17 15:00:00,Hispanic or Latino,690,25639,733.0,11730,,0
2021-02-18 15:00:00,Hispanic or Latino,118,25757,120.0,11850,,0
2021-02-19 15:00:00,Hispanic or Latino,371,26128,743.0,12593,,0
2021-02-20 15:00:00,Hispanic or Latino,364,26492,616.0,13209,,0
2021-02-21 15:00:00,Hispanic or Latino,304,26796,239.0,13448,,0
2021-02-22 15:00:00,Hispanic or Latino,287,27083,410.0,13858,,0
2021-02-23 15:00:00,Hispanic or Latino,511,27594,485.0,14343,,0
2021-02-24 15:00:00,Hispanic or Latino,547,28141,783.0,15126,,0
2021-02-25 15:00:00,Hispanic or Latino,752,28893,804.0,15930,,0
2021-02-26 15:00:00,Hispanic or Latino,1088,29981,821.0,16751,,0
2021-02-27 15:00:00,Hispanic or Latino,647,30628,337.0,17088,,0
2021-02-28 15:00:00,Hispanic or Latino,698,31326,172.0,17260,,0
2021-03-01 15:00:00,Hispanic or Latino,1074,32400,400.0,17660,,0
2021-03-02 15:00:00,Hispanic or Latino,1002,33402,335.0,17995,,0
2021-03-03 15:00:00,Hispanic or Latino,1087,34489,636.0,18631,9.0,9
2021-03-04 15:00:00,Hispanic or Latino,1298,35787,476.0,19107,137.0,146
2021-03-05 15:00:00,Hispanic or Latino,1601,37388,597.0,19704,175.0,321
2021-03-06 15:00:00,Hispanic or Latino,871,38259,272.0,19976,379.0,700
2021-03-07 15:00:00,Hispanic or Latino,528,38787,191.0,20167,279.0,979
2021-03-08 15:00:00,Hispanic or Latino,1181,39968,282.0,20449,357.0,1336
2021-03-09 15:00:00,Hispanic or Latino,1196,41164,473.0,20922,432.0,1768
2021-03-10 15:00:00,Hispanic or Latino,1340,42504,604.0,21526,513.0,2281
2021-03-11 15:00:00,Hispanic or Latino,1484,43988,654.0,22180,225.0,2506
2021-03-12 15:00:00,Hispanic or Latino,1949,45937,610.0,22790,190.0,2696
2021-03-13 15:00:00,Hispanic or Latino,1086,47023,349.0,23139,205.0,2901
2021-03-14 15:00:00,Hispanic or Latino,1354,48377,170.0,23309,96.0,2997
2021-03-15 15:00:00,Hispanic or Latino,1663,50040,311.0,23620,43.0,3040
2021-03-16 15:00:00,Hispanic or Latino,1943,51983,402.0,24022,18.0,3058
2021-03-17 15:00:00,Hispanic or Latino,2393,54376,565.0,24587,59.0,3117
2021-03-18 15:00:00,Hispanic or Latino,2521,56897,378.0,24965,87.0,3204
2021-03-19 15:00:00,Hispanic or Latino,2455,59352,488.0,25453,76.0,3280
2021-03-20 15:00:00,Hispanic or Latino,2060,61412,405.0,25858,46.0,3326
2021-03-21 15:00:00,Hispanic or Latino,1426,62838,362.0,26220,12.0,3338
2021-03-22 15:00:00,Hispanic or Latino,2140,64978,409.0,26629,30.0,3368
2021-03-23 15:00:00,Hispanic or Latino,2503,67481,585.0,27214,133.0,3501
2021-03-24 15:00:00,Hispanic or Latino,3067,70548,791.0,28005,195.0,3696
2021-03-25 15:00:00,Hispanic or Latino,3232,73780,793.0,28798,108.0,3804
2021-03-26 15:00:00,Hispanic or Latino,2422,76202,1206.0,30004,194.0,3998
2021-03-27 15:00:00,Hispanic or Latino,2158,78360,788.0,30792,121.0,4119
2021-03-28 15:00:00,Hispanic or Latino,1059,79419,518.0,31310,69.0,4188
2021-03-29 15:00:00,Hispanic or Latino,1864,81283,1145.0,32455,56.0,4244
2021-03-30 15:00:00,Hispanic or Latino,2330,83613,1039.0,33494,101.0,4345
2021-03-31 15:00:00,Hispanic or Latino,1891,85504,793.0,34287,317.0,4662
2020-12-14 15:00:00,Not Hispanic or Latino,2,2,,0,,0
2020-12-15 15:00:00,Not Hispanic or Latino,8,10,,0,,0
2020-12-16 15:00:00,Not Hispanic or Latino,511,521,1.0,1,,0
2020-12-17 15:00:00,Not Hispanic or Latino,995,1516,,1,,0
2020-12-18 15:00:00,Not Hispanic or Latino,2679,4195,1.0,2,,0
2020-12-19 15:00:00,Not Hispanic or Latino,787,4982,,2,,0
2020-12-20 15:00:00,Not Hispanic or Latino,235,5217,,2,,0
2020-12-21 15:00:00,Not Hispanic or Latino,3498,8715,,2,,0
2020-12-22 15:00:00,Not Hispanic or Latino,5467,14182,3.0,5,,0
2020-12-23 15:00:00,Not Hispanic or Latino,5080,19262,3.0,8,,0
2020-12-24 15:00:00,Not Hispanic or Latino,2481,21743,1.0,9,,0
2020-12-25 15:00:00,Not Hispanic or Latino,793,22536,,9,,0
2020-12-26 15:00:00,Not Hispanic or Latino,1393,23929,1.0,10,,0
2020-12-27 15:00:00,Not Hispanic or Latino,1554,25483,1.0,11,,0
2020-12-28 15:00:00,Not Hispanic or Latino,8037,33520,4.0,15,,0
2020-12-29 15:00:00,Not Hispanic or Latino,9445,42965,3.0,18,,0
2020-12-30 15:00:00,Not Hispanic or Latino,11287,54252,6.0,24,,0
2020-12-31 15:00:00,Not Hispanic or Latino,6775,61027,2.0,26,,0
2021-01-01 15:00:00,Not Hispanic or Latino,1273,62300,12.0,38,,0
2021-01-02 15:00:00,Not Hispanic or Latino,2264,64564,18.0,56,,0
2021-01-03 15:00:00,Not Hispanic or Latino,2765,67329,60.0,116,,0
2021-01-04 15:00:00,Not Hispanic or Latino,11461,78790,225.0,341,,0
2021-01-05 15:00:00,Not Hispanic or Latino,10709,89499,394.0,735,,0
2021-01-06 15:00:00,Not Hispanic or Latino,13097,102596,721.0,1456,,0
2021-01-07 15:00:00,Not Hispanic or Latino,13339,115935,1471.0,2927,,0
2021-01-08 15:00:00,Not Hispanic or Latino,14239,130174,2386.0,5313,,0
2021-01-09 15:00:00,Not Hispanic or Latino,4365,134539,791.0,6104,,0
2021-01-10 15:00:00,Not Hispanic or Latino,2257,136796,296.0,6400,,0
2021-01-11 15:00:00,Not Hispanic or Latino,12369,149165,3035.0,9435,,0
2021-01-12 15:00:00,Not Hispanic or Latino,15167,164332,4727.0,14162,,0
2021-01-13 15:00:00,Not Hispanic or Latino,16713,181045,3354.0,17516,,0
2021-01-14 15:00:00,Not Hispanic or Latino,16119,197164,1690.0,19206,,0
2021-01-15 15:00:00,Not Hispanic or Latino,17426,214590,1514.0,20720,,0
2021-01-16 15:00:00,Not Hispanic or Latino,5096,219686,1089.0,21809,,0
2021-01-17 15:00:00,Not Hispanic or Latino,1808,221494,1173.0,22982,,0
2021-01-18 15:00:00,Not Hispanic or Latino,6741,228235,2528.0,25510,,0
2021-01-19 15:00:00,Not Hispanic or Latino,15487,243722,4137.0,29647,,0
2021-01-20 15:00:00,Not Hispanic or Latino,19507,263229,4452.0,34099,,0
2021-01-21 15:00:00,Not Hispanic or Latino,21697,284926,2983.0,37082,,0
2021-01-22 15:00:00,Not Hispanic or Latino,26498,311424,2875.0,39957,,0
2021-01-23 15:00:00,Not Hispanic or Latino,8671,320095,1265.0,41222,,0
2021-01-24 15:00:00,Not Hispanic or Latino,2917,323012,1349.0,42571,,0
2021-01-25 15:00:00,Not Hispanic or Latino,15196,338208,7259.0,49830,,0
2021-01-26 15:00:00,Not Hispanic or Latino,16077,354285,7630.0,57460,,0
2021-01-27 15:00:00,Not Hispanic or Latino,22681,376966,10887.0,68347,,0
2021-01-28 15:00:00,Not Hispanic or Latino,20854,397820,8158.0,76505,,0
2021-01-29 15:00:00,Not Hispanic or Latino,22560,420380,6242.0,82747,,0
2021-01-30 15:00:00,Not Hispanic or Latino,16507,436887,2114.0,84861,,0
2021-01-31 15:00:00,Not Hispanic or Latino,3133,440020,1068.0,85929,,0
2021-02-01 15:00:00,Not Hispanic or Latino,5724,445744,3660.0,89589,,0
2021-02-02 15:00:00,Not Hispanic or Latino,10713,456457,11786.0,101375,,0
2021-02-03 15:00:00,Not Hispanic or Latino,16093,472550,16429.0,117804,,0
2021-02-04 15:00:00,Not Hispanic or Latino,19810,492360,13928.0,131732,,0
2021-02-05 15:00:00,Not Hispanic or Latino,18326,510686,15395.0,147127,,0
2021-02-06 15:00:00,Not Hispanic or Latino,10203,520889,5613.0,152740,,0
2021-02-07 15:00:00,Not Hispanic or Latino,5163,526052,1402.0,154142,,0
2021-02-08 15:00:00,Not Hispanic or Latino,11299,537351,11484.0,165626,,0
2021-02-09 15:00:00,Not Hispanic or Latino,14594,551945,12356.0,177982,,0
2021-02-10 15:00:00,Not Hispanic or Latino,17267,569212,19485.0,197467,,0
2021-02-11 15:00:00,Not Hispanic or Latino,20776,589988,15509.0,212976,,0
2021-02-12 15:00:00,Not Hispanic or Latino,18178,608166,17568.0,230544,,0
2021-02-13 15:00:00,Not Hispanic or Latino,10103,618269,5542.0,236086,,0
2021-02-14 15:00:00,Not Hispanic or Latino,6149,624418,1694.0,237780,,0
2021-02-15 15:00:00,Not Hispanic or Latino,10843,635261,11146.0,248926,,0
2021-02-16 15:00:00,Not Hispanic or Latino,15190,650451,19120.0,268046,,0
2021-02-17 15:00:00,Not Hispanic or Latino,18921,669372,24344.0,292390,,0
2021-02-18 15:00:00,Not Hispanic or Latino,2875,672247,3783.0,296173,,0
2021-02-19 15:00:00,Not Hispanic or Latino,9686,681933,17617.0,313790,,0
2021-02-20 15:00:00,Not Hispanic or Latino,9170,691103,18647.0,332437,,0
2021-02-21 15:00:00,Not Hispanic or Latino,5367,696470,6667.0,339104,,0
2021-02-22 15:00:00,Not Hispanic or Latino,7302,703772,13940.0,353044,,0
2021-02-23 15:00:00,Not Hispanic or Latino,14161,717933,14353.0,367397,,0
2021-02-24 15:00:00,Not Hispanic or Latino,16491,734424,22785.0,390182,,0
2021-02-25 15:00:00,Not Hispanic or Latino,18439,752863,24147.0,414329,,0
2021-02-26 15:00:00,Not Hispanic or Latino,24231,777094,23751.0,438080,,0
2021-02-27 15:00:00,Not Hispanic or Latino,14422,791516,10020.0,448100,,0
2021-02-28 15:00:00,Not Hispanic or Latino,13817,805333,3994.0,452094,,0
2021-03-01 15:00:00,Not Hispanic or Latino,21722,827055,10255.0,462349,,0
2021-03-02 15:00:00,Not Hispanic or Latino,20871,847926,11698.0,474047,8.0,8
2021-03-03 15:00:00,Not Hispanic or Latino,26222,874148,16400.0,490447,103.0,111
2021-03-04 15:00:00,Not Hispanic or Latino,27155,901303,16303.0,506750,3381.0,3492
2021-03-05 15:00:00,Not Hispanic or Latino,25217,926520,17307.0,524057,4121.0,7613
2021-03-06 15:00:00,Not Hispanic or Latino,15600,942120,7962.0,532019,5294.0,12907
2021-03-07 15:00:00,Not Hispanic or Latino,10129,952249,3923.0,535942,5964.0,18871
2021-03-08 15:00:00,Not Hispanic or Latino,22844,975093,7654.0,543596,7389.0,26260
2021-03-09 15:00:00,Not Hispanic or Latino,22951,998044,13923.0,557519,7397.0,33657
2021-03-10 15:00:00,Not Hispanic or Latino,26411,1024455,14258.0,571777,6803.0,40460
2021-03-11 15:00:00,Not Hispanic or Latino,30307,1054762,14553.0,586330,3190.0,43650
2021-03-12 15:00:00,Not Hispanic or Latino,31969,1086731,14790.0,601120,2001.0,45651
2021-03-13 15:00:00,Not Hispanic or Latino,19072,1105803,8021.0,609141,1079.0,46730
2021-03-14 15:00:00,Not Hispanic or Latino,13749,1119552,4827.0,613968,642.0,47372
2021-03-15 15:00:00,Not Hispanic or Latino,24841,1144393,9612.0,623580,457.0,47829
2021-03-16 15:00:00,Not Hispanic or Latino,28527,1172920,11985.0,635565,684.0,48513
2021-03-17 15:00:00,Not Hispanic or Latino,32130,1205050,15043.0,650608,1014.0,49527
2021-03-18 15:00:00,Not Hispanic or Latino,35536,1240586,10812.0,661420,1000.0,50527
2021-03-19 15:00:00,Not Hispanic or Latino,32225,1272811,13361.0,674781,854.0,51381
2021-03-20 15:00:00,Not Hispanic or Latino,20247,1293058,8772.0,683553,547.0,51928
2021-03-21 15:00:00,Not Hispanic or Latino,14410,1307468,5359.0,688912,258.0,52186
2021-03-22 15:00:00,Not Hispanic or Latino,27625,1335093,9787.0,698699,745.0,52931
2021-03-23 15:00:00,Not Hispanic or Latino,31471,1366564,15074.0,713773,1284.0,54215
2021-03-24 15:00:00,Not Hispanic or Latino,33510,1400074,18561.0,732334,949.0,55164
2021-03-25 15:00:00,Not Hispanic or Latino,34746,1434820,18102.0,750436,1880.0,57044
2021-03-26 15:00:00,Not Hispanic or Latino,30291,1465111,22795.0,773231,1852.0,58896
2021-03-27 15:00:00,Not Hispanic or Latino,21890,1487001,14758.0,787989,1704.0,60600
2021-03-28 15:00:00,Not Hispanic or Latino,13407,1500408,10979.0,798968,1078.0,61678
2021-03-29 15:00:00,Not Hispanic or Latino,22921,1523329,21708.0,820676,922.0,62600
2021-03-30 15:00:00,Not Hispanic or Latino,28251,1551580,22505.0,843181,1305.0,63905
2021-03-31 15:00:00,Not Hispanic or Latino,19491,1571071,19194.0,862375,3254.0,67159
