VACCINATION_DATE,Ethnicity,FirstDoseDaily,FirstDoseCumulative,SecondDoseDaily,SecondDoseCumulative,SingleDoseDaily,SingleDoseCumulative
2020-12-14 15:00:00,Unknown,1,1,,0,,0
2020-12-16 15:00:00,Unknown,10,11,,0,,0
2020-12-17 15:00:00,Unknown,17,28,,0,,0
2020-12-18 15:00:00,Unknown,89,117,,0,,0
2020-12-19 15:00:00,Unknown,27,144,,0,,0
2020-12-20 15:00:00,Unknown,32,176,,0,,0
2020-12-21 15:00:00,Unknown,71,247,,0,,0
2020-12-22 15:00:00,Unknown,416,663,,0,,0
2020-12-23 15:00:00,Unknown,192,855,,0,,0
2020-12-24 15:00:00,Unknown,61,916,,0,,0
2020-12-25 15:00:00,Unknown,183,1099,,0,,0
2020-12-26 15:00:00,Unknown,204,1303,,0,,0
2020-12-27 15:00:00,Unknown,142,1445,,0,,0
2020-12-28 15:00:00,Unknown,279,1724,,0,,0
2020-12-29 15:00:00,Unknown,455,2179,,0,,0
2020-12-30 15:00:00,Unknown,359,2538,,0,,0
2020-12-31 15:00:00,Unknown,222,2760,2.0,2,,0
2021-01-01 15:00:00,Unknown,150,2910,1.0,3,,0
2021-01-02 15:00:00,Unknown,174,3084,2.0,5,,0
2021-01-03 15:00:00,Unknown,235,3319,4.0,9,,0
2021-01-04 15:00:00,Unknown,599,3918,6.0,15,,0
2021-01-05 15:00:00,Unknown,515,4433,18.0,33,,0
2021-01-06 15:00:00,Unknown,666,5099,22.0,55,,0
2021-01-07 15:00:00,Unknown,418,5517,56.0,111,,0
2021-01-08 15:00:00,Unknown,8310,13827,73.0,184,,0
2021-01-09 15:00:00,Unknown,223,14050,41.0,225,,0
2021-01-10 15:00:00,Unknown,180,14230,10.0,235,,0
2021-01-11 15:00:00,Unknown,332,14562,77.0,312,,0
2021-01-12 15:00:00,Unknown,717,15279,347.0,659,,0
2021-01-13 15:00:00,Unknown,405,15684,134.0,793,,0
2021-01-14 15:00:00,Unknown,395,16079,59.0,852,,0
2021-01-15 15:00:00,Unknown,543,16622,181.0,1033,,0
2021-01-16 15:00:00,Unknown,302,16924,165.0,1198,,0
2021-01-17 15:00:00,Unknown,111,17035,98.0,1296,,0
2021-01-18 15:00:00,Unknown,181,17216,201.0,1497,,0
2021-01-19 15:00:00,Unknown,300,17516,244.0,1741,,0
2021-01-20 15:00:00,Unknown,350,17866,159.0,1900,,0
2021-01-21 15:00:00,Unknown,454,18320,82.0,1982,,0
2021-01-22 15:00:00,Unknown,712,19032,165.0,2147,,0
2021-01-23 15:00:00,Unknown,418,19450,131.0,2278,,0
2021-01-24 15:00:00,Unknown,201,19651,154.0,2432,,0
2021-01-25 15:00:00,Unknown,556,20207,472.0,2904,,0
2021-01-26 15:00:00,Unknown,647,20854,375.0,3279,,0
2021-01-27 15:00:00,Unknown,507,21361,537.0,3816,,0
2021-01-28 15:00:00,Unknown,485,21846,275.0,4091,,0
2021-01-29 15:00:00,Unknown,485,22331,205.0,4296,,0
2021-01-30 15:00:00,Unknown,305,22636,49.0,4345,,0
2021-01-31 15:00:00,Unknown,360,22996,86.0,4431,,0
2021-02-01 15:00:00,Unknown,435,23431,198.0,4629,,0
2021-02-02 15:00:00,Unknown,596,24027,647.0,5276,,0
2021-02-03 15:00:00,Unknown,704,24731,464.0,5740,,0
2021-02-04 15:00:00,Unknown,863,25594,413.0,6153,,0
2021-02-05 15:00:00,Unknown,671,26265,426.0,6579,,0
2021-02-06 15:00:00,Unknown,383,26648,8210.0,14789,,0
2021-02-07 15:00:00,Unknown,382,27030,92.0,14881,,0
2021-02-08 15:00:00,Unknown,691,27721,254.0,15135,,0
2021-02-09 15:00:00,Unknown,748,28469,298.0,15433,,0
2021-02-10 15:00:00,Unknown,824,29293,402.0,15835,,0
2021-02-11 15:00:00,Unknown,889,30182,403.0,16238,,0
2021-02-12 15:00:00,Unknown,759,30941,556.0,16794,,0
2021-02-13 15:00:00,Unknown,413,31354,157.0,16951,,0
2021-02-14 15:00:00,Unknown,445,31799,130.0,17081,,0
2021-02-15 15:00:00,Unknown,461,32260,534.0,17615,,0
2021-02-16 15:00:00,Unknown,716,32976,682.0,18297,,0
2021-02-17 15:00:00,Unknown,819,33795,477.0,18774,,0
2021-02-18 15:00:00,Unknown,266,34061,256.0,19030,,0
2021-02-19 15:00:00,Unknown,571,34632,474.0,19504,,0
2021-02-20 15:00:00,Unknown,600,35232,398.0,19902,,0
2021-02-21 15:00:00,Unknown,346,35578,335.0,20237,,0
2021-02-22 15:00:00,Unknown,432,36010,427.0,20664,,0
2021-02-23 15:00:00,Unknown,657,36667,395.0,21059,,0
2021-02-24 15:00:00,Unknown,614,37281,503.0,21562,,0
2021-02-25 15:00:00,Unknown,615,37896,828.0,22390,,0
2021-02-26 15:00:00,Unknown,759,38655,745.0,23135,,0
2021-02-27 15:00:00,Unknown,565,39220,302.0,23437,,0
2021-02-28 15:00:00,Unknown,642,39862,207.0,23644,,0
2021-03-01 15:00:00,Unknown,833,40695,489.0,24133,,0
2021-03-02 15:00:00,Unknown,765,41460,537.0,24670,1.0,1
2021-03-03 15:00:00,Unknown,967,42427,596.0,25266,3.0,4
2021-03-04 15:00:00,Unknown,953,43380,682.0,25948,105.0,109
2021-03-05 15:00:00,Unknown,983,44363,564.0,26512,88.0,197
2021-03-06 15:00:00,Unknown,659,45022,305.0,26817,187.0,384
2021-03-07 15:00:00,Unknown,538,45560,333.0,27150,298.0,682
2021-03-08 15:00:00,Unknown,906,46466,347.0,27497,369.0,1051
2021-03-09 15:00:00,Unknown,874,47340,458.0,27955,378.0,1429
2021-03-10 15:00:00,Unknown,801,48141,497.0,28452,506.0,1935
2021-03-11 15:00:00,Unknown,970,49111,520.0,28972,194.0,2129
2021-03-12 15:00:00,Unknown,1189,50300,628.0,29600,163.0,2292
2021-03-13 15:00:00,Unknown,856,51156,377.0,29977,78.0,2370
2021-03-14 15:00:00,Unknown,1052,52208,360.0,30337,70.0,2440
2021-03-15 15:00:00,Unknown,1648,53856,403.0,30740,36.0,2476
2021-03-16 15:00:00,Unknown,1603,55459,587.0,31327,45.0,2521
2021-03-17 15:00:00,Unknown,1614,57073,683.0,32010,62.0,2583
2021-03-18 15:00:00,Unknown,1780,58853,454.0,32464,58.0,2641
2021-03-19 15:00:00,Unknown,1456,60309,432.0,32896,55.0,2696
2021-03-20 15:00:00,Unknown,1287,61596,443.0,33339,38.0,2734
2021-03-21 15:00:00,Unknown,1109,62705,478.0,33817,25.0,2759
2021-03-22 15:00:00,Unknown,1587,64292,498.0,34315,33.0,2792
2021-03-23 15:00:00,Unknown,1992,66284,612.0,34927,76.0,2868
2021-03-24 15:00:00,Unknown,2617,68901,530.0,35457,78.0,2946
2021-03-25 15:00:00,Unknown,2641,71542,597.0,36054,332.0,3278
2021-03-26 15:00:00,Unknown,2595,74137,686.0,36740,362.0,3640
2021-03-27 15:00:00,Unknown,1883,76020,514.0,37254,404.0,4044
2021-03-28 15:00:00,Unknown,1927,77947,506.0,37760,430.0,4474
2021-03-29 15:00:00,Unknown,2676,80623,946.0,38706,76.0,4550
2021-03-30 15:00:00,Unknown,2535,83158,987.0,39693,126.0,4676
2021-03-31 15:00:00,Unknown,2529,85687,859.0,40552,814.0,5490
2021-04-01 15:00:00,Unknown,1833,87520,990.0,41542,633.0,6123
2021-04-13 15:00:00,Federal Entities,84295,84295,54201.0,54201,2952.0,2952
2021-04-14 15:00:00,Federal Entities,557,84852,11.0,54212,1.0,2953
2021-04-15 15:00:00,Federal Entities,623,85475,823.0,55035,19.0,2972
2021-04-16 15:00:00,Federal Entities,782,86257,1016.0,56051,8.0,2980
2021-04-17 15:00:00,Federal Entities,1136,87393,1177.0,57228,6.0,2986
2021-04-19 15:00:00,Federal Entities,1369,88762,2003.0,59231,9.0,2995
2021-04-20 15:00:00,Federal Entities,3243,92005,2158.0,61389,19.0,3014
2021-04-21 15:00:00,Federal Entities,906,92911,1206.0,62595,4.0,3018
2021-04-22 15:00:00,Federal Entities,1018,93929,458.0,63053,,3018
2021-04-23 15:00:00,Federal Entities,759,94688,632.0,63685,1.0,3019
2021-04-25 15:00:00,Federal Entities,992,95680,2492.0,66177,5.0,3024
2021-04-26 15:00:00,Federal Entities,1483,97163,1672.0,67849,1.0,3025
2021-04-29 15:00:00,Federal Entities,223,97386,865.0,68714,2.0,3027
2021-05-01 15:00:00,Federal Entities,1556,98942,1974.0,70688,14.0,3041
2021-05-02 15:00:00,Federal Entities,1071,100013,1875.0,72563,4.0,3045
2021-05-03 15:00:00,Federal Entities,403,100416,2165.0,74728,4.0,3049
2021-05-04 15:00:00,Federal Entities,28,100444,25.0,74753,,3049
2021-05-05 15:00:00,Federal Entities,365,100809,814.0,75567,,3049
2021-05-06 15:00:00,Federal Entities,275,101084,880.0,76447,3.0,3052
2021-05-07 15:00:00,Federal Entities,274,101358,966.0,77413,8.0,3060
2021-05-08 15:00:00,Federal Entities,297,101655,1312.0,78725,6.0,3066
2021-05-10 15:00:00,Federal Entities,338,101993,1712.0,80437,1.0,3067
2021-05-11 15:00:00,Federal Entities,18,102011,13.0,80450,,3067
2021-05-12 15:00:00,Federal Entities,243,102254,1124.0,81574,,3067
2021-05-14 15:00:00,Federal Entities,290,102544,1022.0,82596,2.0,3069
2021-05-15 15:00:00,Federal Entities,611,103155,1701.0,84297,4.0,3073
2021-05-17 15:00:00,Federal Entities,565,103720,2505.0,86802,11.0,3084
2021-05-18 15:00:00,Federal Entities,164,103884,61.0,86863,2.0,3086
2021-05-20 15:00:00,Federal Entities,885,104769,1024.0,87887,,3086
2021-05-22 15:00:00,Federal Entities,911,105680,1359.0,89246,9.0,3095
2021-05-24 15:00:00,Federal Entities,514,106194,1032.0,90278,8.0,3103
2021-05-25 15:00:00,Federal Entities,5,106199,1.0,90279,2.0,3105
2021-05-27 15:00:00,Federal Entities,425,106624,674.0,90953,1.0,3106
2021-05-28 15:00:00,Federal Entities,418,107042,342.0,91295,,3106
2021-05-29 15:00:00,Federal Entities,267,107309,344.0,91639,10.0,3116
2020-12-15 15:00:00,Hispanic or Latino,2,2,,0,,0
2020-12-16 15:00:00,Hispanic or Latino,18,20,,0,,0
2020-12-17 15:00:00,Hispanic or Latino,34,54,,0,,0
2020-12-18 15:00:00,Hispanic or Latino,85,139,,0,,0
2020-12-19 15:00:00,Hispanic or Latino,33,172,,0,,0
2020-12-20 15:00:00,Hispanic or Latino,8,180,,0,,0
2020-12-21 15:00:00,Hispanic or Latino,149,329,1.0,1,,0
2020-12-22 15:00:00,Hispanic or Latino,251,580,,1,,0
2020-12-23 15:00:00,Hispanic or Latino,182,762,1.0,2,,0
2020-12-24 15:00:00,Hispanic or Latino,89,851,,2,,0
2020-12-25 15:00:00,Hispanic or Latino,37,888,,2,,0
2020-12-26 15:00:00,Hispanic or Latino,39,927,,2,,0
2020-12-27 15:00:00,Hispanic or Latino,57,984,,2,,0
2020-12-28 15:00:00,Hispanic or Latino,258,1242,1.0,3,,0
2020-12-29 15:00:00,Hispanic or Latino,361,1603,1.0,4,,0
2020-12-30 15:00:00,Hispanic or Latino,500,2103,2.0,6,,0
2020-12-31 15:00:00,Hispanic or Latino,315,2418,2.0,8,,0
2021-01-01 15:00:00,Hispanic or Latino,50,2468,4.0,12,,0
2021-01-02 15:00:00,Hispanic or Latino,81,2549,2.0,14,,0
2021-01-03 15:00:00,Hispanic or Latino,117,2666,3.0,17,,0
2021-01-04 15:00:00,Hispanic or Latino,607,3273,12.0,29,,0
2021-01-05 15:00:00,Hispanic or Latino,400,3673,19.0,48,,0
2021-01-06 15:00:00,Hispanic or Latino,575,4248,19.0,67,,0
2021-01-07 15:00:00,Hispanic or Latino,799,5047,56.0,123,,0
2021-01-08 15:00:00,Hispanic or Latino,871,5918,89.0,212,,0
2021-01-09 15:00:00,Hispanic or Latino,196,6114,31.0,243,,0
2021-01-10 15:00:00,Hispanic or Latino,133,6247,21.0,264,,0
2021-01-11 15:00:00,Hispanic or Latino,548,6795,126.0,390,,0
2021-01-12 15:00:00,Hispanic or Latino,729,7524,206.0,596,,0
2021-01-13 15:00:00,Hispanic or Latino,665,8189,131.0,727,,0
2021-01-14 15:00:00,Hispanic or Latino,746,8935,63.0,790,,0
2021-01-15 15:00:00,Hispanic or Latino,873,9808,63.0,853,,0
2021-01-16 15:00:00,Hispanic or Latino,183,9991,43.0,896,,0
2021-01-17 15:00:00,Hispanic or Latino,99,10090,38.0,934,,0
2021-01-18 15:00:00,Hispanic or Latino,169,10259,110.0,1044,,0
2021-01-19 15:00:00,Hispanic or Latino,469,10728,152.0,1196,,0
2021-01-20 15:00:00,Hispanic or Latino,615,11343,174.0,1370,,0
2021-01-21 15:00:00,Hispanic or Latino,758,12101,116.0,1486,,0
2021-01-22 15:00:00,Hispanic or Latino,951,13052,103.0,1589,,0
2021-01-23 15:00:00,Hispanic or Latino,329,13381,50.0,1639,,0
2021-01-24 15:00:00,Hispanic or Latino,98,13479,37.0,1676,,0
2021-01-25 15:00:00,Hispanic or Latino,371,13850,301.0,1977,,0
2021-01-26 15:00:00,Hispanic or Latino,501,14351,225.0,2202,,0
2021-01-27 15:00:00,Hispanic or Latino,743,15094,431.0,2633,,0
2021-01-28 15:00:00,Hispanic or Latino,790,15884,387.0,3020,,0
2021-01-29 15:00:00,Hispanic or Latino,691,16575,295.0,3315,,0
2021-01-30 15:00:00,Hispanic or Latino,483,17058,89.0,3404,,0
2021-01-31 15:00:00,Hispanic or Latino,132,17190,28.0,3432,,0
2021-02-01 15:00:00,Hispanic or Latino,165,17355,150.0,3582,,0
2021-02-02 15:00:00,Hispanic or Latino,418,17773,589.0,4171,,0
2021-02-03 15:00:00,Hispanic or Latino,609,18382,667.0,4838,,0
2021-02-04 15:00:00,Hispanic or Latino,723,19105,711.0,5549,,0
2021-02-05 15:00:00,Hispanic or Latino,753,19858,870.0,6419,,0
2021-02-06 15:00:00,Hispanic or Latino,384,20242,203.0,6622,,0
2021-02-07 15:00:00,Hispanic or Latino,168,20410,60.0,6682,,0
2021-02-08 15:00:00,Hispanic or Latino,522,20932,593.0,7275,,0
2021-02-09 15:00:00,Hispanic or Latino,548,21480,512.0,7787,,0
2021-02-10 15:00:00,Hispanic or Latino,692,22172,683.0,8470,,0
2021-02-11 15:00:00,Hispanic or Latino,859,23031,723.0,9193,,0
2021-02-12 15:00:00,Hispanic or Latino,766,23797,843.0,10036,,0
2021-02-13 15:00:00,Hispanic or Latino,370,24167,223.0,10259,,0
2021-02-14 15:00:00,Hispanic or Latino,277,24444,63.0,10322,,0
2021-02-15 15:00:00,Hispanic or Latino,319,24763,361.0,10683,,0
2021-02-16 15:00:00,Hispanic or Latino,502,25265,540.0,11223,,0
2021-02-17 15:00:00,Hispanic or Latino,693,25958,735.0,11958,,0
2021-02-18 15:00:00,Hispanic or Latino,115,26073,126.0,12084,,0
2021-02-19 15:00:00,Hispanic or Latino,373,26446,748.0,12832,,0
2021-02-20 15:00:00,Hispanic or Latino,373,26819,625.0,13457,,0
2021-02-21 15:00:00,Hispanic or Latino,310,27129,243.0,13700,,0
2021-02-22 15:00:00,Hispanic or Latino,288,27417,408.0,14108,,0
2021-02-23 15:00:00,Hispanic or Latino,519,27936,481.0,14589,,0
2021-02-24 15:00:00,Hispanic or Latino,563,28499,799.0,15388,,0
2021-02-25 15:00:00,Hispanic or Latino,773,29272,814.0,16202,,0
2021-02-26 15:00:00,Hispanic or Latino,1114,30386,833.0,17035,,0
2021-02-27 15:00:00,Hispanic or Latino,664,31050,336.0,17371,,0
2021-02-28 15:00:00,Hispanic or Latino,718,31768,177.0,17548,,0
2021-03-01 15:00:00,Hispanic or Latino,1113,32881,413.0,17961,,0
2021-03-02 15:00:00,Hispanic or Latino,1045,33926,345.0,18306,,0
2021-03-03 15:00:00,Hispanic or Latino,1139,35065,646.0,18952,13.0,13
2021-03-04 15:00:00,Hispanic or Latino,1338,36403,483.0,19435,150.0,163
2021-03-05 15:00:00,Hispanic or Latino,1637,38040,596.0,20031,202.0,365
2021-03-06 15:00:00,Hispanic or Latino,891,38931,278.0,20309,384.0,749
2021-03-07 15:00:00,Hispanic or Latino,577,39508,198.0,20507,287.0,1036
2021-03-08 15:00:00,Hispanic or Latino,1200,40708,298.0,20805,361.0,1397
2021-03-09 15:00:00,Hispanic or Latino,1226,41934,480.0,21285,437.0,1834
2021-03-10 15:00:00,Hispanic or Latino,1372,43306,613.0,21898,522.0,2356
2021-04-02 15:00:00,Unknown,1888,89408,1280.0,42822,762.0,6885
2021-04-03 15:00:00,Unknown,1661,91069,850.0,43672,670.0,7555
2021-04-04 15:00:00,Unknown,617,91686,670.0,44342,49.0,7604
2021-04-05 15:00:00,Unknown,1857,93543,1135.0,45477,678.0,8282
2021-04-06 15:00:00,Unknown,2221,95764,1259.0,46736,896.0,9178
2021-04-07 15:00:00,Unknown,2459,98223,1351.0,48087,1357.0,10535
2021-04-08 15:00:00,Unknown,3079,101302,1516.0,49603,1524.0,12059
2021-04-09 15:00:00,Unknown,3330,104632,1079.0,50682,1294.0,13353
2021-04-10 15:00:00,Unknown,2788,107420,1063.0,51745,1002.0,14355
2021-04-11 15:00:00,Unknown,2514,109934,1083.0,52828,869.0,15224
2021-04-12 15:00:00,Unknown,2834,112768,1891.0,54719,1102.0,16326
2021-04-13 15:00:00,Unknown,3338,116106,1901.0,56620,33.0,16359
2021-04-14 15:00:00,Unknown,3180,119286,2176.0,58796,10.0,16369
2021-04-15 15:00:00,Unknown,3802,123088,2324.0,61120,14.0,16383
2021-04-16 15:00:00,Unknown,3412,126500,2391.0,63511,1.0,16384
2021-04-17 15:00:00,Unknown,3709,130209,1667.0,65178,1.0,16385
2021-04-18 15:00:00,Unknown,2975,133184,1713.0,66891,,16385
2021-04-19 15:00:00,Unknown,2831,136015,2437.0,69328,3.0,16388
2021-04-20 15:00:00,Unknown,2302,138317,2187.0,71515,,16388
2021-04-21 15:00:00,Unknown,3100,141417,2524.0,74039,,16388
2021-04-22 15:00:00,Unknown,2775,144192,1300.0,75339,,16388
2021-04-23 15:00:00,Unknown,3265,147457,1985.0,77324,2.0,16390
2021-04-24 15:00:00,Unknown,3166,150623,1550.0,78874,3.0,16393
2021-04-25 15:00:00,Unknown,2440,153063,774.0,79648,,16393
2021-04-26 15:00:00,Unknown,1813,154876,1525.0,81173,11.0,16404
2021-04-27 15:00:00,Unknown,2393,157269,1466.0,82639,80.0,16484
2021-04-28 15:00:00,Unknown,2149,159418,2604.0,85243,94.0,16578
2021-04-29 15:00:00,Unknown,1950,161368,2711.0,87954,78.0,16656
2021-04-30 15:00:00,Unknown,2102,163470,2797.0,90751,113.0,16769
2021-05-01 15:00:00,Unknown,1653,165123,2625.0,93376,58.0,16827
2021-05-02 15:00:00,Unknown,1299,166422,2269.0,95645,38.0,16865
2021-05-03 15:00:00,Unknown,818,167240,2794.0,98439,91.0,16956
2021-05-04 15:00:00,Unknown,850,168090,3057.0,101496,105.0,17061
2021-05-05 15:00:00,Unknown,1514,169604,2973.0,104469,117.0,17178
2021-05-06 15:00:00,Unknown,1324,170928,3329.0,107798,92.0,17270
2021-05-07 15:00:00,Unknown,1377,172305,2882.0,110680,107.0,17377
2021-05-08 15:00:00,Unknown,1109,173414,3200.0,113880,109.0,17486
2021-05-09 15:00:00,Unknown,741,174155,1561.0,115441,36.0,17522
2021-05-10 15:00:00,Unknown,724,174879,2919.0,118360,82.0,17604
2021-05-11 15:00:00,Unknown,857,175736,2353.0,120713,83.0,17687
2021-05-12 15:00:00,Unknown,1002,176738,2761.0,123474,157.0,17844
2021-05-13 15:00:00,Unknown,1254,177992,2389.0,125863,143.0,17987
2021-05-14 15:00:00,Unknown,1408,179400,2410.0,128273,186.0,18173
2021-05-15 15:00:00,Unknown,1626,181026,2503.0,130776,232.0,18405
2021-05-16 15:00:00,Unknown,649,181675,2162.0,132938,201.0,18606
2021-05-17 15:00:00,Unknown,781,182456,1761.0,134699,227.0,18833
2021-05-18 15:00:00,Unknown,1253,183709,2619.0,137318,195.0,19028
2021-05-19 15:00:00,Unknown,1316,185025,2486.0,139804,162.0,19190
2021-05-20 15:00:00,Unknown,1095,186120,2038.0,141842,163.0,19353
2021-05-21 15:00:00,Unknown,1151,187271,2006.0,143848,193.0,19546
2021-05-22 15:00:00,Unknown,1226,188497,1116.0,144964,224.0,19770
2021-05-23 15:00:00,Unknown,649,189146,1207.0,146171,180.0,19950
2021-05-24 15:00:00,Unknown,799,189945,829.0,147000,221.0,20171
2021-03-11 15:00:00,Hispanic or Latino,1523,44829,661.0,22559,254.0,2610
2021-03-12 15:00:00,Hispanic or Latino,2062,46891,653.0,23212,219.0,2829
2021-03-13 15:00:00,Hispanic or Latino,1207,48098,387.0,23599,212.0,3041
2021-03-14 15:00:00,Hispanic or Latino,1524,49622,211.0,23810,108.0,3149
2021-03-15 15:00:00,Hispanic or Latino,1763,51385,341.0,24151,42.0,3191
2021-03-16 15:00:00,Hispanic or Latino,2041,53426,413.0,24564,21.0,3212
2021-03-17 15:00:00,Hispanic or Latino,2469,55895,576.0,25140,59.0,3271
2021-03-18 15:00:00,Hispanic or Latino,2601,58496,386.0,25526,99.0,3370
2021-03-19 15:00:00,Hispanic or Latino,2601,61097,525.0,26051,83.0,3453
2021-03-20 15:00:00,Hispanic or Latino,2116,63213,411.0,26462,46.0,3499
2021-03-21 15:00:00,Hispanic or Latino,1615,64828,447.0,26909,15.0,3514
2021-03-22 15:00:00,Hispanic or Latino,2209,67037,433.0,27342,31.0,3545
2021-03-23 15:00:00,Hispanic or Latino,2630,69667,608.0,27950,133.0,3678
2021-03-24 15:00:00,Hispanic or Latino,3188,72855,819.0,28769,203.0,3881
2021-03-25 15:00:00,Hispanic or Latino,3339,76194,833.0,29602,114.0,3995
2021-03-26 15:00:00,Hispanic or Latino,2493,78687,1235.0,30837,200.0,4195
2021-03-27 15:00:00,Hispanic or Latino,2220,80907,806.0,31643,137.0,4332
2021-03-28 15:00:00,Hispanic or Latino,1112,82019,540.0,32183,70.0,4402
2021-03-29 15:00:00,Hispanic or Latino,1996,84015,1217.0,33400,60.0,4462
2021-03-30 15:00:00,Hispanic or Latino,2725,86740,1174.0,34574,108.0,4570
2021-03-31 15:00:00,Hispanic or Latino,3389,90129,1329.0,35903,392.0,4962
2021-04-01 15:00:00,Hispanic or Latino,2869,92998,1652.0,37555,293.0,5255
2021-04-02 15:00:00,Hispanic or Latino,2744,95742,1866.0,39421,328.0,5583
2021-04-03 15:00:00,Hispanic or Latino,2112,97854,983.0,40404,277.0,5860
2021-04-04 15:00:00,Hispanic or Latino,687,98541,570.0,40974,50.0,5910
2021-04-05 15:00:00,Hispanic or Latino,2290,100831,1503.0,42477,360.0,6270
2021-04-06 15:00:00,Hispanic or Latino,3105,103936,1777.0,44254,510.0,6780
2021-04-07 15:00:00,Hispanic or Latino,3526,107462,1743.0,45997,860.0,7640
2021-04-08 15:00:00,Hispanic or Latino,3317,110779,1894.0,47891,1202.0,8842
2021-04-09 15:00:00,Hispanic or Latino,3221,114000,2176.0,50067,1091.0,9933
2021-04-10 15:00:00,Hispanic or Latino,2195,116195,1556.0,51623,605.0,10538
2021-04-11 15:00:00,Hispanic or Latino,2147,118342,1318.0,52941,640.0,11178
2021-04-12 15:00:00,Hispanic or Latino,2166,120508,2099.0,55040,776.0,11954
2021-04-13 15:00:00,Hispanic or Latino,3625,124133,2494.0,57534,30.0,11984
2021-04-14 15:00:00,Hispanic or Latino,4414,128547,2572.0,60106,35.0,12019
2021-04-15 15:00:00,Hispanic or Latino,3659,132206,2237.0,62343,24.0,12043
2021-04-16 15:00:00,Hispanic or Latino,3711,135917,2785.0,65128,,12043
2021-04-17 15:00:00,Hispanic or Latino,3663,139580,1825.0,66953,,12043
2021-04-18 15:00:00,Hispanic or Latino,2363,141943,1184.0,68137,,12043
2021-04-19 15:00:00,Hispanic or Latino,3369,145312,1887.0,70024,4.0,12047
2021-04-20 15:00:00,Hispanic or Latino,3556,148868,2440.0,72464,,12047
2021-04-21 15:00:00,Hispanic or Latino,5013,153881,3103.0,75567,,12047
2021-04-22 15:00:00,Hispanic or Latino,3915,157796,3184.0,78751,,12047
2021-04-23 15:00:00,Hispanic or Latino,3670,161466,3023.0,81774,,12047
2021-04-24 15:00:00,Hispanic or Latino,4305,165771,2551.0,84325,7.0,12054
2021-04-25 15:00:00,Hispanic or Latino,2868,168639,814.0,85139,3.0,12057
2021-04-26 15:00:00,Hispanic or Latino,3556,172195,2405.0,87544,16.0,12073
2021-04-27 15:00:00,Hispanic or Latino,3534,175729,2564.0,90108,113.0,12186
2021-04-28 15:00:00,Hispanic or Latino,3658,179387,3612.0,93720,142.0,12328
2021-04-29 15:00:00,Hispanic or Latino,3575,182962,3044.0,96764,151.0,12479
2021-04-30 15:00:00,Hispanic or Latino,4103,187065,2698.0,99462,170.0,12649
2021-05-01 15:00:00,Hispanic or Latino,3388,190453,2209.0,101671,129.0,12778
2021-05-02 15:00:00,Hispanic or Latino,1585,192038,1601.0,103272,126.0,12904
2021-05-03 15:00:00,Hispanic or Latino,1888,193926,2182.0,105454,238.0,13142
2021-05-04 15:00:00,Hispanic or Latino,1833,195759,3114.0,108568,175.0,13317
2021-05-05 15:00:00,Hispanic or Latino,2836,198595,3759.0,112327,217.0,13534
2021-05-06 15:00:00,Hispanic or Latino,2132,200727,3410.0,115737,165.0,13699
2021-05-07 15:00:00,Hispanic or Latino,2951,203678,3471.0,119208,191.0,13890
2021-05-08 15:00:00,Hispanic or Latino,1978,205656,3118.0,122326,173.0,14063
2021-05-09 15:00:00,Hispanic or Latino,939,206595,1438.0,123764,100.0,14163
2021-05-10 15:00:00,Hispanic or Latino,1273,207868,3049.0,126813,139.0,14302
2021-05-11 15:00:00,Hispanic or Latino,1757,209625,2998.0,129811,155.0,14457
2021-05-12 15:00:00,Hispanic or Latino,2213,211838,4184.0,133995,335.0,14792
2021-05-13 15:00:00,Hispanic or Latino,2429,214267,3395.0,137390,118.0,14910
2021-05-14 15:00:00,Hispanic or Latino,3285,217552,2873.0,140263,185.0,15095
2021-05-15 15:00:00,Hispanic or Latino,3198,220750,3299.0,143562,229.0,15324
2021-05-16 15:00:00,Hispanic or Latino,1376,222126,2252.0,145814,198.0,15522
2021-05-17 15:00:00,Hispanic or Latino,1894,224020,3083.0,148897,188.0,15710
2021-05-18 15:00:00,Hispanic or Latino,2690,226710,3708.0,152605,225.0,15935
2021-05-19 15:00:00,Hispanic or Latino,3748,230458,3677.0,156282,208.0,16143
2021-05-20 15:00:00,Hispanic or Latino,2213,232671,3051.0,159333,201.0,16344
2021-05-21 15:00:00,Hispanic or Latino,2277,234948,3394.0,162727,175.0,16519
2021-05-22 15:00:00,Hispanic or Latino,2504,237452,2419.0,165146,206.0,16725
2021-05-23 15:00:00,Hispanic or Latino,1263,238715,1264.0,166410,128.0,16853
2021-05-24 15:00:00,Hispanic or Latino,1943,240658,2351.0,168761,173.0,17026
2021-05-25 15:00:00,Hispanic or Latino,2027,242685,2260.0,171021,139.0,17165
2021-05-26 15:00:00,Hispanic or Latino,2380,245065,2489.0,173510,147.0,17312
2021-05-27 15:00:00,Hispanic or Latino,1324,246389,1978.0,175488,110.0,17422
2021-05-28 15:00:00,Hispanic or Latino,1669,248058,2583.0,178071,156.0,17578
2021-05-29 15:00:00,Hispanic or Latino,881,248939,1334.0,179405,70.0,17648
2021-05-25 15:00:00,Unknown,997,190942,841.0,147841,137.0,20308
2021-05-26 15:00:00,Unknown,898,191840,1049.0,148890,170.0,20478
2021-05-27 15:00:00,Unknown,617,192457,892.0,149782,122.0,20600
2021-05-28 15:00:00,Unknown,770,193227,1149.0,150931,172.0,20772
2021-05-29 15:00:00,Unknown,787,194014,1105.0,152036,272.0,21044
2020-12-14 15:00:00,Not Hispanic or Latino,2,2,,0,,0
2020-12-15 15:00:00,Not Hispanic or Latino,13,15,1.0,1,,0
2020-12-16 15:00:00,Not Hispanic or Latino,521,536,2.0,3,,0
2020-12-17 15:00:00,Not Hispanic or Latino,1011,1547,,3,,0
2020-12-18 15:00:00,Not Hispanic or Latino,2699,4246,2.0,5,,0
2020-12-19 15:00:00,Not Hispanic or Latino,796,5042,1.0,6,,0
2020-12-20 15:00:00,Not Hispanic or Latino,247,5289,2.0,8,,0
2020-12-21 15:00:00,Not Hispanic or Latino,3511,8800,3.0,11,,0
2020-12-22 15:00:00,Not Hispanic or Latino,5527,14327,2.0,13,,0
2020-12-23 15:00:00,Not Hispanic or Latino,5110,19437,12.0,25,,0
2020-12-24 15:00:00,Not Hispanic or Latino,2496,21933,4.0,29,,0
2020-12-25 15:00:00,Not Hispanic or Latino,811,22744,2.0,31,,0
2020-12-26 15:00:00,Not Hispanic or Latino,1426,24170,3.0,34,,0
2020-12-27 15:00:00,Not Hispanic or Latino,1571,25741,4.0,38,,0
2020-12-28 15:00:00,Not Hispanic or Latino,8092,33833,10.0,48,,0
2020-12-29 15:00:00,Not Hispanic or Latino,9623,43456,8.0,56,,0
2020-12-30 15:00:00,Not Hispanic or Latino,11336,54792,20.0,76,,0
2020-12-31 15:00:00,Not Hispanic or Latino,6847,61639,9.0,85,,0
2021-01-01 15:00:00,Not Hispanic or Latino,1486,63125,33.0,118,,0
2021-01-02 15:00:00,Not Hispanic or Latino,2432,65557,21.0,139,,0
2021-01-03 15:00:00,Not Hispanic or Latino,2835,68392,62.0,201,,0
2021-01-04 15:00:00,Not Hispanic or Latino,11700,80092,242.0,443,,0
2021-01-05 15:00:00,Not Hispanic or Latino,11051,91143,411.0,854,,0
2021-01-06 15:00:00,Not Hispanic or Latino,13496,104639,733.0,1587,,0
2021-01-07 15:00:00,Not Hispanic or Latino,13445,118084,1490.0,3077,,0
2021-01-08 15:00:00,Not Hispanic or Latino,14505,132589,2411.0,5488,,0
2021-01-09 15:00:00,Not Hispanic or Latino,4546,137135,803.0,6291,,0
2021-01-10 15:00:00,Not Hispanic or Latino,2452,139587,310.0,6601,,0
2021-01-11 15:00:00,Not Hispanic or Latino,12579,152166,3063.0,9664,,0
2021-01-12 15:00:00,Not Hispanic or Latino,15580,167746,4792.0,14456,,0
2021-01-13 15:00:00,Not Hispanic or Latino,17087,184833,3442.0,17898,,0
2021-01-14 15:00:00,Not Hispanic or Latino,16313,201146,1714.0,19612,,0
2021-01-15 15:00:00,Not Hispanic or Latino,17584,218730,1578.0,21190,,0
2021-01-16 15:00:00,Not Hispanic or Latino,5022,223752,1318.0,22508,,0
2021-01-17 15:00:00,Not Hispanic or Latino,1899,225651,1188.0,23696,,0
2021-01-18 15:00:00,Not Hispanic or Latino,6789,232440,2580.0,26276,,0
2021-01-19 15:00:00,Not Hispanic or Latino,15807,248247,4418.0,30694,,0
2021-01-20 15:00:00,Not Hispanic or Latino,19624,267871,4557.0,35251,,0
2021-01-21 15:00:00,Not Hispanic or Latino,21926,289797,3113.0,38364,,0
2021-01-22 15:00:00,Not Hispanic or Latino,26671,316468,3003.0,41367,,0
2021-01-23 15:00:00,Not Hispanic or Latino,8780,325248,1358.0,42725,,0
2021-01-24 15:00:00,Not Hispanic or Latino,2990,328238,1373.0,44098,,0
2021-01-25 15:00:00,Not Hispanic or Latino,15330,343568,7328.0,51426,,0
2021-01-26 15:00:00,Not Hispanic or Latino,16262,359830,7946.0,59372,,0
2021-01-27 15:00:00,Not Hispanic or Latino,22879,382709,11123.0,70495,,0
2021-01-28 15:00:00,Not Hispanic or Latino,21150,403859,8322.0,78817,,0
2021-01-29 15:00:00,Not Hispanic or Latino,22802,426661,6669.0,85486,,0
2021-01-30 15:00:00,Not Hispanic or Latino,16727,443388,2174.0,87660,,0
2021-01-31 15:00:00,Not Hispanic or Latino,3184,446572,1105.0,88765,,0
2021-02-01 15:00:00,Not Hispanic or Latino,6049,452621,3954.0,92719,,0
2021-02-02 15:00:00,Not Hispanic or Latino,11051,463672,12127.0,104846,,0
2021-02-03 15:00:00,Not Hispanic or Latino,16433,480105,16540.0,121386,,0
2021-02-04 15:00:00,Not Hispanic or Latino,20167,500272,14159.0,135545,,0
2021-02-05 15:00:00,Not Hispanic or Latino,18494,518766,15649.0,151194,,0
2021-02-06 15:00:00,Not Hispanic or Latino,10246,529012,5768.0,156962,,0
2021-02-07 15:00:00,Not Hispanic or Latino,5279,534291,1505.0,158467,,0
2021-02-08 15:00:00,Not Hispanic or Latino,11511,545802,11665.0,170132,,0
2021-02-09 15:00:00,Not Hispanic or Latino,15068,560870,12549.0,182681,,0
2021-02-10 15:00:00,Not Hispanic or Latino,17555,578425,19623.0,202304,,0
2021-02-11 15:00:00,Not Hispanic or Latino,20973,599398,15764.0,218068,,0
2021-02-12 15:00:00,Not Hispanic or Latino,18625,618023,17708.0,235776,,0
2021-02-13 15:00:00,Not Hispanic or Latino,10471,628494,5596.0,241372,,0
2021-02-14 15:00:00,Not Hispanic or Latino,6288,634782,1778.0,243150,,0
2021-02-15 15:00:00,Not Hispanic or Latino,10828,645610,11925.0,255075,,0
2021-02-16 15:00:00,Not Hispanic or Latino,15259,660869,19340.0,274415,,0
2021-02-17 15:00:00,Not Hispanic or Latino,19002,679871,24631.0,299046,,0
2021-02-18 15:00:00,Not Hispanic or Latino,2729,682600,4013.0,303059,,0
2021-02-19 15:00:00,Not Hispanic or Latino,9543,692143,17967.0,321026,,0
2021-02-20 15:00:00,Not Hispanic or Latino,9266,701409,18797.0,339823,,0
2021-02-21 15:00:00,Not Hispanic or Latino,5407,706816,6835.0,346658,,0
2021-02-22 15:00:00,Not Hispanic or Latino,7263,714079,14166.0,360824,,0
2021-02-23 15:00:00,Not Hispanic or Latino,14249,728328,14602.0,375426,,0
2021-02-24 15:00:00,Not Hispanic or Latino,16645,744973,22983.0,398409,,0
2021-02-25 15:00:00,Not Hispanic or Latino,18791,763764,24471.0,422880,,0
2021-02-26 15:00:00,Not Hispanic or Latino,24643,788407,23985.0,446865,,0
2021-02-27 15:00:00,Not Hispanic or Latino,14561,802968,10243.0,457108,,0
2021-02-28 15:00:00,Not Hispanic or Latino,14035,817003,4211.0,461319,,0
2021-03-01 15:00:00,Not Hispanic or Latino,22418,839421,10577.0,471896,,0
2021-03-02 15:00:00,Not Hispanic or Latino,21593,861014,11928.0,483824,18.0,18
2021-03-03 15:00:00,Not Hispanic or Latino,27336,888350,16648.0,500472,134.0,152
2021-03-04 15:00:00,Not Hispanic or Latino,28242,916592,16557.0,517029,3805.0,3957
2021-03-05 15:00:00,Not Hispanic or Latino,25851,942443,17578.0,534607,4561.0,8518
2021-03-06 15:00:00,Not Hispanic or Latino,16021,958464,8089.0,542696,5380.0,13898
2021-03-07 15:00:00,Not Hispanic or Latino,10816,969280,4171.0,546867,5975.0,19873
2021-03-08 15:00:00,Not Hispanic or Latino,23313,992593,7788.0,554655,7459.0,27332
2021-03-09 15:00:00,Not Hispanic or Latino,23567,1016160,14112.0,568767,7436.0,34768
2021-03-10 15:00:00,Not Hispanic or Latino,27065,1043225,14417.0,583184,6881.0,41649
2021-03-11 15:00:00,Not Hispanic or Latino,31121,1074346,14882.0,598066,3484.0,45133
2021-03-12 15:00:00,Not Hispanic or Latino,33203,1107549,16338.0,614404,2501.0,47634
2021-03-13 15:00:00,Not Hispanic or Latino,20357,1127906,9191.0,623595,1271.0,48905
2021-03-14 15:00:00,Not Hispanic or Latino,15112,1143018,5962.0,629557,788.0,49693
2021-03-15 15:00:00,Not Hispanic or Latino,25918,1168936,10121.0,639678,479.0,50172
2021-03-16 15:00:00,Not Hispanic or Latino,29312,1198248,12109.0,651787,694.0,50866
2021-03-17 15:00:00,Not Hispanic or Latino,32978,1231226,15246.0,667033,1021.0,51887
2021-03-18 15:00:00,Not Hispanic or Latino,36487,1267713,11288.0,678321,1180.0,53067
2021-03-19 15:00:00,Not Hispanic or Latino,33486,1301199,13959.0,692280,882.0,53949
2021-03-20 15:00:00,Not Hispanic or Latino,20758,1321957,8890.0,701170,590.0,54539
2021-03-21 15:00:00,Not Hispanic or Latino,16104,1338061,6667.0,707837,274.0,54813
2021-03-22 15:00:00,Not Hispanic or Latino,28463,1366524,10062.0,717899,753.0,55566
2021-03-23 15:00:00,Not Hispanic or Latino,32719,1399243,15588.0,733487,1312.0,56878
2021-03-24 15:00:00,Not Hispanic or Latino,34824,1434067,19169.0,752656,1072.0,57950
2021-03-25 15:00:00,Not Hispanic or Latino,35938,1470005,18969.0,771625,2010.0,59960
2021-03-26 15:00:00,Not Hispanic or Latino,31272,1501277,23405.0,795030,1934.0,61894
2021-03-27 15:00:00,Not Hispanic or Latino,22739,1524016,15138.0,810168,1842.0,63736
2021-03-28 15:00:00,Not Hispanic or Latino,13834,1537850,11362.0,821530,1110.0,64846
2021-03-29 15:00:00,Not Hispanic or Latino,24882,1562732,23527.0,845057,989.0,65835
2021-03-30 15:00:00,Not Hispanic or Latino,34312,1597044,26173.0,871230,1596.0,67431
2021-03-31 15:00:00,Not Hispanic or Latino,34655,1631699,31691.0,902921,4524.0,71955
2021-04-01 15:00:00,Not Hispanic or Latino,36016,1667715,33901.0,936822,4521.0,76476
2021-04-02 15:00:00,Not Hispanic or Latino,29819,1697534,28429.0,965251,4684.0,81160
2021-04-03 15:00:00,Not Hispanic or Latino,17664,1715198,16404.0,981655,3426.0,84586
2021-04-04 15:00:00,Not Hispanic or Latino,6950,1722148,8759.0,990414,830.0,85416
2021-04-05 15:00:00,Not Hispanic or Latino,23479,1745627,25617.0,1016031,5566.0,90982
2021-04-06 15:00:00,Not Hispanic or Latino,34190,1779817,26688.0,1042719,9035.0,100017
2021-04-07 15:00:00,Not Hispanic or Latino,29619,1809436,30317.0,1073036,10630.0,110647
2021-04-08 15:00:00,Not Hispanic or Latino,35471,1844907,31992.0,1105028,11021.0,121668
2021-04-09 15:00:00,Not Hispanic or Latino,27101,1872008,32321.0,1137349,12025.0,133693
2021-04-10 15:00:00,Not Hispanic or Latino,18265,1890273,20082.0,1157431,5933.0,139626
2021-04-11 15:00:00,Not Hispanic or Latino,12828,1903101,10726.0,1168157,8565.0,148191
2021-04-12 15:00:00,Not Hispanic or Latino,19497,1922598,28658.0,1196815,8994.0,157185
2021-04-13 15:00:00,Not Hispanic or Latino,35386,1957984,31412.0,1228227,277.0,157462
2021-04-14 15:00:00,Not Hispanic or Latino,32320,1990304,32329.0,1260556,156.0,157618
2021-04-15 15:00:00,Not Hispanic or Latino,33226,2023530,32944.0,1293500,109.0,157727
2021-04-16 15:00:00,Not Hispanic or Latino,28988,2052518,31873.0,1325373,9.0,157736
2021-04-17 15:00:00,Not Hispanic or Latino,24157,2076675,16894.0,1342267,4.0,157740
2021-04-18 15:00:00,Not Hispanic or Latino,14329,2091004,13004.0,1355271,3.0,157743
2021-04-19 15:00:00,Not Hispanic or Latino,22021,2113025,29557.0,1384828,46.0,157789
2021-04-20 15:00:00,Not Hispanic or Latino,23129,2136154,36011.0,1420839,32.0,157821
2021-04-21 15:00:00,Not Hispanic or Latino,29165,2165319,36937.0,1457776,15.0,157836
2021-04-22 15:00:00,Not Hispanic or Latino,27973,2193292,34873.0,1492649,16.0,157852
2021-04-23 15:00:00,Not Hispanic or Latino,24383,2217675,32955.0,1525604,12.0,157864
2021-04-24 15:00:00,Not Hispanic or Latino,18783,2236458,23326.0,1548930,63.0,157927
2021-04-25 15:00:00,Not Hispanic or Latino,13856,2250314,6609.0,1555539,21.0,157948
2021-04-26 15:00:00,Not Hispanic or Latino,20013,2270327,26207.0,1581746,177.0,158125
2021-04-27 15:00:00,Not Hispanic or Latino,20431,2290758,28233.0,1609979,900.0,159025
2021-04-28 15:00:00,Not Hispanic or Latino,22516,2313274,31987.0,1641966,1120.0,160145
2021-04-29 15:00:00,Not Hispanic or Latino,21065,2334339,31352.0,1673318,1193.0,161338
2021-04-30 15:00:00,Not Hispanic or Latino,21178,2355517,25398.0,1698716,1315.0,162653
2021-05-01 15:00:00,Not Hispanic or Latino,13062,2368579,17918.0,1716634,767.0,163420
2021-05-02 15:00:00,Not Hispanic or Latino,6238,2374817,11097.0,1727731,627.0,164047
2021-05-03 15:00:00,Not Hispanic or Latino,9663,2384480,21805.0,1749536,1563.0,165610
2021-05-04 15:00:00,Not Hispanic or Latino,11037,2395517,31746.0,1781282,1437.0,167047
2021-05-05 15:00:00,Not Hispanic or Latino,14017,2409534,28747.0,1810029,1556.0,168603
2021-05-06 15:00:00,Not Hispanic or Latino,13101,2422635,31322.0,1841351,1421.0,170024
2021-05-07 15:00:00,Not Hispanic or Latino,12570,2435205,27346.0,1868697,1607.0,171631
2021-05-08 15:00:00,Not Hispanic or Latino,7100,2442305,22642.0,1891339,991.0,172622
2021-05-09 15:00:00,Not Hispanic or Latino,3481,2445786,8468.0,1899807,553.0,173175
2021-05-10 15:00:00,Not Hispanic or Latino,6486,2452272,22646.0,1922453,1120.0,174295
2021-05-11 15:00:00,Not Hispanic or Latino,9099,2461371,23386.0,1945839,1178.0,175473
2021-05-12 15:00:00,Not Hispanic or Latino,10687,2472058,29155.0,1974994,1376.0,176849
2021-05-13 15:00:00,Not Hispanic or Latino,17802,2489860,26712.0,2001706,1069.0,177918
2021-05-14 15:00:00,Not Hispanic or Latino,18888,2508748,22397.0,2024103,1376.0,179294
2021-05-15 15:00:00,Not Hispanic or Latino,16103,2524851,16997.0,2041100,976.0,180270
2021-05-16 15:00:00,Not Hispanic or Latino,6654,2531505,12726.0,2053826,694.0,180964
2021-05-17 15:00:00,Not Hispanic or Latino,13560,2545065,20192.0,2074018,1421.0,182385
2021-05-18 15:00:00,Not Hispanic or Latino,16650,2561715,23214.0,2097232,1480.0,183865
2021-05-19 15:00:00,Not Hispanic or Latino,20744,2582459,22877.0,2120109,1093.0,184958
2021-05-20 15:00:00,Not Hispanic or Latino,13384,2595843,22027.0,2142136,1365.0,186323
2021-05-21 15:00:00,Not Hispanic or Latino,12860,2608703,20113.0,2162249,1026.0,187349
2021-05-22 15:00:00,Not Hispanic or Latino,9747,2618450,11649.0,2173898,644.0,187993
2021-05-23 15:00:00,Not Hispanic or Latino,4691,2623141,5791.0,2179689,494.0,188487
2021-05-24 15:00:00,Not Hispanic or Latino,9833,2632974,12772.0,2192461,1020.0,189507
2021-05-25 15:00:00,Not Hispanic or Latino,8768,2641742,13836.0,2206297,909.0,190416
2021-05-26 15:00:00,Not Hispanic or Latino,11107,2652849,12218.0,2218515,914.0,191330
2021-05-27 15:00:00,Not Hispanic or Latino,6360,2659209,11172.0,2229687,704.0,192034
2021-05-28 15:00:00,Not Hispanic or Latino,6817,2666026,10638.0,2240325,785.0,192819
2021-05-29 15:00:00,Not Hispanic or Latino,2692,2668718,4321.0,2244646,250.0,193069
